"gene_name","gene_ort","TDN_num_patients","TP_num_patients","TDN_num_sites","TP_num_sites","TDN_sum_abund","TP_sum_abund","TDN_same_ort","TDN_oppo_ort","TP_same_ort","TP_oppo_ort","ort_fisher_test","abund_gini","Overlapping_Genes","On_Onco_List","Top_1pc_Abund","Top_10pc_Abund","Within_Cluster","Cluster_target.min"
"'SRCAP","+",19,11,41,35,50,1031,24,17,32,3,0.00145376130292509,0.929447982119513,"SNORA30",FALSE,TRUE,TRUE,FALSE,NA
"'TET2","+",7,6,10,25,12,1747,4,6,21,4,0.0160489197818256,0.928126788780767,"TET2-AS1",TRUE,TRUE,TRUE,FALSE,NA
"'TET2-AS1","-",8,6,9,22,11,1744,6,3,3,19,0.00683901225565877,0.915225829216655,"TET2",FALSE,TRUE,TRUE,FALSE,NA
"'PIKFYVE","+",5,10,5,16,5,769,3,2,11,5,1,0.901928912006935,"",FALSE,TRUE,TRUE,FALSE,NA
"'MTMR3","+",18,6,45,19,52,380,25,20,13,6,0.410774134325131,0.88640350877193,"MIR6818, HORMAD2-AS1",TRUE,TRUE,TRUE,FALSE,NA
"'SSH2","-",24,10,70,39,81,302,36,34,29,10,0.0250978053825108,0.861995300149541,"EFCAB5",FALSE,TRUE,TRUE,FALSE,NA
"'PCNX1","+",21,11,43,28,44,288,19,24,21,7,0.014441415244906,0.840939153439153,"",FALSE,TRUE,TRUE,FALSE,NA
"'LEF1","-",17,9,34,23,49,181,16,18,17,6,0.0580891703414464,0.832105586249233,"LEF1-AS1",TRUE,TRUE,TRUE,FALSE,NA
"'RSRC1","+",14,9,21,20,26,158,10,11,13,7,0.349886699961309,0.826401446654611,"",FALSE,TRUE,TRUE,FALSE,NA
"'UMAD1","+",14,6,17,13,22,137,5,12,8,5,0.137619126944464,0.816605839416058,"RPA3",FALSE,TRUE,TRUE,FALSE,NA
"'TRIO","+",2,4,3,13,3,160,0,3,9,4,0.0624999999999999,0.814285714285714,"SNORD170",TRUE,TRUE,TRUE,FALSE,NA
"'UBR1","-",21,10,43,23,48,127,18,25,18,5,0.00873494815987597,0.805336832895888,"",FALSE,TRUE,TRUE,FALSE,NA
"'JMJD6","-",7,2,7,13,7,97,3,4,13,0,0.00722394220846233,0.805154639175258,"",FALSE,TRUE,TRUE,TRUE,0.0577591979432278
"'AQR","-",12,5,12,10,20,100,6,6,4,6,0.691355084543939,0.805,"",FALSE,TRUE,TRUE,FALSE,NA
"'RPA3","-",7,5,7,12,12,136,5,2,5,7,0.34984520123839,0.804621848739496,"UMAD1",FALSE,TRUE,TRUE,FALSE,NA
"'METTL23","+",7,4,7,14,7,99,6,1,0,14,0.000128998968008256,0.80257116620753,"",FALSE,FALSE,TRUE,TRUE,0.0577591979432278
"'MGA","+",16,12,40,32,42,162,19,21,24,8,0.0289132989449629,0.797325102880658,"MIR626",FALSE,TRUE,TRUE,FALSE,NA
"'PATL1","-",6,4,8,11,9,1220,4,4,2,9,0.318885448916409,0.79672131147541,"",FALSE,TRUE,TRUE,FALSE,NA
"'EXOSC10","-",10,4,14,9,20,95,9,5,8,1,0.340128978572915,0.790977443609022,"LOC105376736",FALSE,TRUE,TRUE,FALSE,NA
"'MAPK14","+",15,9,29,23,29,136,11,18,15,8,0.0929351695438391,0.790247678018576,"",TRUE,TRUE,TRUE,FALSE,NA
"'SMAP2","+",8,6,14,10,15,85,8,6,7,3,0.678456050612465,0.786554621848739,"",FALSE,TRUE,TRUE,FALSE,NA
"'N4BP1","-",7,6,9,13,9,102,5,4,9,4,0.661919504643963,0.786492374727669,"",FALSE,TRUE,TRUE,FALSE,NA
"'DNAJC13","+",13,9,14,17,16,113,7,7,12,5,0.28830810401251,0.784660766961652,"",FALSE,TRUE,TRUE,FALSE,NA
"'CARD8","-",24,14,119,55,137,253,62,57,27,28,0.746184357159424,0.782698526769673,"CARD8-AS1",TRUE,TRUE,TRUE,FALSE,NA
"'PA2G4","+",10,6,15,14,16,86,7,8,13,1,0.0141929035482259,0.781007751937985,"",FALSE,TRUE,TRUE,FALSE,NA
"'ATP2A2","+",12,8,23,18,24,120,12,11,11,7,0.75230623933573,0.778571428571429,"",FALSE,TRUE,TRUE,FALSE,NA
"'RSBN1L","+",6,6,10,10,12,68,6,4,8,2,0.628482972136223,0.772058823529412,"APTR",FALSE,TRUE,TRUE,FALSE,NA
"'IQCB1","-",4,5,5,7,5,128,1,4,5,2,0.242424242424243,0.76875,"",FALSE,TRUE,TRUE,FALSE,NA
"'GPN1","+",8,3,10,8,10,114,5,5,7,1,0.15158371040724,0.760233918128655,"CCDC121, SUPT7L",FALSE,TRUE,TRUE,FALSE,NA
"'HSF5","-",14,6,18,10,20,64,15,3,10,0,0.532967032967033,0.756944444444444,"",FALSE,TRUE,TRUE,FALSE,NA
"'CHD1L","+",2,3,2,9,2,55,0,2,8,1,0.0545454545454545,0.747727272727273,"PDIA3P1, FMO5",FALSE,TRUE,TRUE,FALSE,NA
"'DNAJC1","-",10,7,16,12,16,58,8,8,6,6,1,0.747126436781609,"",FALSE,TRUE,TRUE,FALSE,NA
"'POLG2","-",5,3,6,11,8,62,4,2,8,3,1,0.746543778801843,"",FALSE,TRUE,TRUE,FALSE,NA
"'SEC31A","-",9,6,10,12,11,87,7,3,10,2,0.62406015037594,0.745484400656814,"THAP9-AS1, SNORD143, SNORD144",FALSE,TRUE,TRUE,FALSE,NA
"'PPP6R3","+",20,15,70,67,81,265,38,32,47,20,0.07786340223404,0.744968553459119,"",FALSE,TRUE,TRUE,TRUE,3.15138669424078
"'HERC4","-",14,8,18,21,22,103,9,9,10,11,1,0.737864077669903,"POU5F1P5",FALSE,TRUE,TRUE,FALSE,NA
"'PTGES3","-",15,6,28,9,30,52,19,9,9,0,0.0785812744034298,0.735576923076923,"",FALSE,TRUE,TRUE,TRUE,1.21234367547959
"'ZZEF1","-",29,13,90,66,103,247,49,41,53,13,0.00111178017826905,0.735571961578154,"MIR5096",FALSE,TRUE,TRUE,TRUE,1.7740421349779
"'DYNC1H1","+",9,8,13,15,14,65,7,6,14,1,0.0286231884057971,0.734615384615384,"",FALSE,TRUE,TRUE,FALSE,NA
"'MEMO1","-",14,5,19,8,21,62,10,9,6,2,0.404830917874396,0.729032258064516,"",FALSE,TRUE,TRUE,FALSE,NA
"'STAG3","+",10,5,23,12,23,56,14,9,6,6,0.721023359288098,0.727272727272727,"GATS",FALSE,TRUE,TRUE,FALSE,NA
"'ELMO1","-",15,5,24,11,28,46,10,14,9,2,0.0353567455903384,0.717391304347826,"MIR1200, ELMO1-AS1",TRUE,TRUE,TRUE,FALSE,NA
"'KIFC1","+",13,6,21,17,24,72,9,12,14,3,0.0201917713041183,0.714646464646465,"",FALSE,TRUE,TRUE,FALSE,NA
"'MSH5-SAPCD1","+",16,4,25,6,27,49,12,13,4,2,0.653936472623903,0.710204081632653,"MSH5, SAPCD1, SAPCD1-AS1",FALSE,TRUE,TRUE,FALSE,NA
"'NCAPH2","+",20,5,37,12,45,53,19,18,9,3,0.191801022606069,0.710120068610635,"SCO2",FALSE,TRUE,TRUE,FALSE,NA
"'PPFIA1","+",11,6,18,18,23,65,9,9,14,4,0.164182424916574,0.708974358974359,"MIR548K",FALSE,TRUE,TRUE,FALSE,NA
"'SNORA58B","+",3,5,3,8,3,50,1,2,8,0,0.0545454545454546,0.706666666666667,"UBAP2L",FALSE,FALSE,FALSE,TRUE,0.527246214813246
"'XPO1","-",5,5,6,8,6,39,4,2,6,2,1,0.705128205128205,"",FALSE,TRUE,TRUE,FALSE,NA
"'MAD1L1","-",16,6,21,13,24,51,14,7,9,4,1,0.702317290552585,"MIR4655, SNORA114",TRUE,TRUE,TRUE,FALSE,NA
"'PDE3B","+",14,4,29,21,32,71,19,10,16,5,0.536817507889544,0.701584507042254,"",FALSE,TRUE,TRUE,FALSE,NA
"'PHF20","+",16,6,32,15,38,66,15,17,12,3,0.0562880430852094,0.699300699300699,"",TRUE,TRUE,TRUE,FALSE,NA
"'PHF12","-",10,2,13,9,16,63,7,6,8,1,0.164860681114551,0.694444444444444,"LOC101927018",FALSE,TRUE,TRUE,FALSE,NA
"'AP1S2","-",4,4,4,8,4,38,2,2,8,0,0.090909090909091,0.692982456140351,"",FALSE,TRUE,TRUE,FALSE,NA
"'DERL2","-",9,7,10,9,13,52,8,2,8,1,1,0.692307692307692,"",FALSE,TRUE,TRUE,FALSE,NA
"'ECD","-",7,6,9,16,9,54,4,5,14,2,0.0581235697940503,0.689458689458689,"",FALSE,TRUE,TRUE,FALSE,NA
"'AUH","-",15,8,23,19,24,78,13,10,11,8,1,0.689102564102564,"",TRUE,TRUE,TRUE,FALSE,NA
"'BRD2","+",15,7,25,12,30,50,11,14,9,3,0.0939188831291168,0.688888888888889,"",TRUE,TRUE,TRUE,FALSE,NA
"'OGFOD1","+",7,5,7,14,9,63,5,2,11,3,1,0.687830687830688,"",FALSE,TRUE,TRUE,FALSE,NA
"'POM121","+",4,5,4,9,6,37,1,3,8,1,0.0517482517482517,0.687258687258687,"NSUN5P2",FALSE,TRUE,TRUE,FALSE,NA
"'NHLRC2","+",6,5,9,10,10,35,6,3,6,4,1,0.685714285714286,"",FALSE,TRUE,TRUE,FALSE,NA
"'PTBP1","+",11,8,18,26,20,100,12,6,12,14,0.226782110078418,0.684,"MIR4745",TRUE,TRUE,TRUE,FALSE,NA
"'TRIM37","-",17,10,27,20,28,79,13,14,17,3,0.0138945444021064,0.683544303797468,"PPM1E",TRUE,TRUE,TRUE,FALSE,NA
"'RABGAP1","+",13,4,14,10,14,40,8,6,3,7,0.239668865257774,0.68125,"GPR21",FALSE,TRUE,TRUE,FALSE,NA
"'TMEM123","-",4,3,4,13,5,46,1,3,3,10,1,0.679347826086956,"LOC101928424",FALSE,TRUE,TRUE,FALSE,NA
"'PPP1CC","-",5,4,7,6,7,33,5,2,4,2,1,0.678787878787879,"",TRUE,TRUE,TRUE,FALSE,NA
"'ZNF565","-",10,5,13,12,18,42,7,6,8,4,0.688167990308251,0.678571428571429,"ZNF146",FALSE,TRUE,TRUE,FALSE,NA
"'TGFBR2","+",6,2,6,7,6,42,2,4,5,2,0.286130536130536,0.678571428571429,"",TRUE,TRUE,TRUE,FALSE,NA
"'HTT","+",17,9,28,17,28,62,15,13,9,8,1,0.67741935483871,"",FALSE,TRUE,TRUE,FALSE,NA
"'BAG6","-",17,6,41,18,51,70,25,16,12,6,0.774812168217602,0.676190476190476,"APOM",FALSE,TRUE,TRUE,FALSE,NA
"'RAB18","+",7,6,10,9,11,39,4,6,5,4,0.656281798696659,0.673992673992674,"",FALSE,TRUE,TRUE,FALSE,NA
"'PCNX3","+",15,5,26,7,27,31,11,15,5,2,0.224503095470837,0.672043010752688,"MIR4690",FALSE,TRUE,TRUE,FALSE,NA
"'EIF2AK4","+",4,3,6,8,6,59,4,2,7,1,0.538461538461538,0.671186440677966,"",FALSE,TRUE,TRUE,FALSE,NA
"'ZNF573","-",9,3,11,5,12,98,7,4,3,2,1,0.668367346938776,"",FALSE,TRUE,TRUE,FALSE,NA
"'SNAP29","+",3,3,3,6,3,36,3,0,3,3,0.464285714285714,0.666666666666667,"",FALSE,TRUE,TRUE,FALSE,NA
"'RMND5A","+",4,5,8,5,8,30,4,4,3,2,1,0.666666666666667,"RNF103-CHMP3",FALSE,TRUE,TRUE,FALSE,NA
"'NAP1L1","-",4,5,5,11,5,43,1,4,10,1,0.0128205128205128,0.665697674418605,"",FALSE,TRUE,TRUE,FALSE,NA
"'VMP1","+",24,10,95,44,105,149,54,41,27,17,0.712313540586577,0.663412649989831,"PTRH2, MIR21",FALSE,TRUE,TRUE,FALSE,NA
"'ANKRD46","-",9,5,13,8,16,37,7,6,6,2,0.399862401100791,0.662162162162162,"",FALSE,TRUE,TRUE,FALSE,NA
"'DCUN1D4","+",9,3,12,10,12,55,6,6,7,3,0.414860681114551,0.661818181818182,"",FALSE,TRUE,TRUE,FALSE,NA
"'MED13L","-",20,11,45,31,55,94,23,22,22,9,0.100470221089334,0.659574468085106,"MIR620",FALSE,TRUE,TRUE,FALSE,NA
"'MTUS1","-",3,4,4,7,4,55,1,3,5,2,0.242424242424243,0.659090909090909,"MIR548V",TRUE,TRUE,TRUE,FALSE,NA
"'ITM2B","+",7,4,8,6,11,33,3,5,5,1,0.137529137529137,0.659090909090909,"",FALSE,TRUE,TRUE,FALSE,NA
"'YLPM1","+",12,9,21,18,25,59,11,10,14,4,0.179889566986341,0.657838983050847,"",FALSE,TRUE,TRUE,FALSE,NA
"'SNHG12","-",1,2,1,8,2,198,0,1,0,8,1,0.656565656565656,"TRNAU1AP, SNORD99, SNORA61, SNORA44, SNORA16A",FALSE,TRUE,TRUE,FALSE,NA
"'CAAP1","-",8,4,10,7,10,36,8,2,3,4,0.161764705882353,0.655555555555556,"",FALSE,TRUE,TRUE,FALSE,NA
"'SEPT9","+",17,5,35,10,41,41,21,14,4,6,0.30105200099528,0.655487804878049,"LOC105371907, MIR4316",TRUE,TRUE,TRUE,FALSE,NA
"'CHMP2B","+",8,7,10,12,14,49,7,3,7,5,0.674922600619195,0.655102040816327,"",FALSE,TRUE,TRUE,FALSE,NA
"'PDCD4","+",13,8,19,20,21,54,14,5,15,5,1,0.653439153439153,"MIR4680, BBIP1",TRUE,TRUE,TRUE,FALSE,NA
"'ZNF92","+",0,1,0,9,0,60,0,0,3,6,1,0.653333333333333,"",FALSE,TRUE,TRUE,FALSE,NA
"'ADD1","+",23,10,55,33,58,104,27,28,28,5,0.00123935873693251,0.65185676392573,"",FALSE,TRUE,TRUE,FALSE,NA
"'FAM117A","-",3,3,4,7,4,27,3,1,6,1,1,0.651851851851852,"",TRUE,TRUE,TRUE,FALSE,NA
"'SFI1","+",18,6,57,14,67,47,25,32,8,6,0.390299677561421,0.649903288201161,"PISD",FALSE,TRUE,TRUE,FALSE,NA
"'ATF7","-",17,10,37,21,40,75,20,17,16,5,0.158478051491807,0.64962962962963,"LOC100652999",FALSE,TRUE,TRUE,FALSE,NA
"'GOLPH3L","-",18,4,36,12,47,39,18,18,7,5,0.743388979881419,0.649572649572649,"",FALSE,TRUE,TRUE,FALSE,NA
"'CASC3","+",15,5,22,9,23,33,10,12,8,1,0.0448362915316535,0.649350649350649,"MIR6866",TRUE,TRUE,TRUE,FALSE,NA
"'MPP7","-",11,8,12,13,13,38,9,3,9,4,1,0.645933014354067,"SNORD130, MIR8086",FALSE,TRUE,TRUE,FALSE,NA
"'SBNO1","-",12,8,24,14,29,48,10,14,13,1,0.0021214152987675,0.643939393939394,"MIR8072",TRUE,TRUE,TRUE,FALSE,NA
"'NDST3","+",2,3,2,8,2,28,0,2,7,1,0.0666666666666666,0.642857142857143,"",FALSE,TRUE,TRUE,FALSE,NA
"'PCMTD2","+",11,6,15,13,16,44,8,7,12,1,0.0376811594202899,0.640151515151515,"",FALSE,TRUE,TRUE,FALSE,NA
"'LONP2","+",10,5,13,9,13,33,6,7,6,3,0.414860681114551,0.640151515151515,"SIAH1",FALSE,TRUE,TRUE,FALSE,NA
"'XPO5","-",16,12,37,28,45,85,18,19,26,2,0.000142660148270268,0.639411764705883,"POLR1C",FALSE,TRUE,TRUE,FALSE,NA
"'POGZ","-",11,9,18,13,19,45,11,7,11,2,0.237421289355323,0.638888888888889,"",FALSE,TRUE,TRUE,FALSE,NA
"'GOLIM4","-",5,3,5,6,5,27,2,3,4,2,0.567099567099567,0.638888888888889,"",FALSE,TRUE,TRUE,FALSE,NA
"'TRIP13","+",5,4,5,9,6,36,3,2,5,4,1,0.634920634920635,"",FALSE,TRUE,TRUE,FALSE,NA
"'RNASEH2A","+",4,4,4,7,4,25,1,3,5,2,0.242424242424243,0.633333333333333,"",FALSE,TRUE,TRUE,FALSE,NA
"'ERMP1","-",7,5,10,10,11,30,4,6,8,2,0.169802333889021,0.633333333333333,"",FALSE,TRUE,TRUE,FALSE,NA
"'HELLS","+",9,10,10,22,13,67,2,8,14,8,0.0538021311924682,0.629353233830846,"",FALSE,FALSE,TRUE,TRUE,0.316030041287781
"'SNORD117","-",18,11,31,29,34,76,14,17,23,6,0.0085055917351628,0.62929061784897,"DDX39B, ATP6V1G2-DDX39B",FALSE,TRUE,TRUE,FALSE,NA
"'NGDN","+",3,3,4,4,4,50,1,3,4,0,0.142857142857143,0.626666666666667,"",FALSE,TRUE,TRUE,FALSE,NA
"'RFC4","-",5,5,8,5,9,23,5,3,3,2,1,0.626086956521739,"EIF4A2",FALSE,TRUE,TRUE,FALSE,NA
"'SBF1","-",9,5,16,10,18,32,8,8,7,3,0.427863777089783,0.625,"PPP6R2",FALSE,TRUE,TRUE,FALSE,NA
"'DDX39B","-",23,12,37,30,41,77,18,19,23,7,0.0245684197733971,0.623917748917749,"MCCD1, ATP6V1G2-DDX39B, SNORD117, SNORD84, DDX39B-AS1",FALSE,TRUE,TRUE,FALSE,NA
"'TARSL2","-",8,9,13,13,15,42,8,5,5,8,0.4337526681153,0.623015873015873,"",FALSE,TRUE,TRUE,FALSE,NA
"'STK4","+",26,11,61,32,70,89,30,31,26,6,0.00351244710856223,0.622846441947565,"",TRUE,TRUE,TRUE,FALSE,NA
"'KMT2D","-",15,7,28,17,33,50,14,14,12,5,0.222393374877038,0.618823529411765,"",TRUE,TRUE,TRUE,FALSE,NA
"'UBR5","-",16,8,26,21,27,55,13,13,12,9,0.770362086660074,0.618181818181818,"",FALSE,TRUE,TRUE,FALSE,NA
"'CENPE","-",7,4,13,7,14,28,3,10,6,1,0.016640866873065,0.614285714285714,"",FALSE,TRUE,TRUE,FALSE,NA
"'SSU72","-",13,5,21,18,26,52,10,11,15,3,0.0427502029281785,0.612637362637362,"",FALSE,TRUE,TRUE,TRUE,1.38675131315115
"'SRSF11","+",8,6,8,16,8,45,1,7,9,7,0.079075857511717,0.612345679012346,"",FALSE,TRUE,TRUE,FALSE,NA
"'PRRC2B","+",9,6,16,10,16,35,7,9,8,2,0.109247543410957,0.612244897959184,"SNORD62A, SNORD62B",FALSE,TRUE,TRUE,FALSE,NA
"'SIPA1L1","+",8,7,11,14,12,40,2,9,9,5,0.041886525777359,0.609090909090909,"",FALSE,TRUE,TRUE,FALSE,NA
"'LOC102725126","+",9,7,11,13,13,33,4,7,9,4,0.217326404245909,0.609090909090909,"FRG1HP, PGM5P2",FALSE,TRUE,TRUE,FALSE,NA
"'FRG1HP","+",9,7,11,13,13,33,4,7,9,4,0.217326404245909,0.609090909090909,"LOC102725126, PGM5P2",FALSE,TRUE,TRUE,FALSE,NA
"'ZNF644","-",7,4,9,9,9,31,4,5,6,3,0.637186343068696,0.60752688172043,"",FALSE,TRUE,TRUE,FALSE,NA
"'HIVEP3","-",13,4,30,8,31,40,16,14,5,3,0.708726321629548,0.607142857142857,"",TRUE,TRUE,TRUE,FALSE,NA
"'ATP6V1G2-DDX39B","-",24,12,47,33,58,84,21,26,24,9,0.0214165207756143,0.605820105820106,"MCCD1, DDX39B, SNORD117, SNORD84, DDX39B-AS1, ATP6V1G2",FALSE,TRUE,TRUE,FALSE,NA
"'GRSF1","-",0,2,0,4,0,32,0,0,4,0,1,0.604166666666667,"",FALSE,TRUE,TRUE,FALSE,NA
"'MED13","-",15,13,51,33,64,90,25,26,23,10,0.0738361367593788,0.604115226337449,"",FALSE,TRUE,TRUE,FALSE,NA
"'SMURF2","-",17,9,46,18,53,54,23,23,11,7,0.578555715342403,0.602469135802469,"",FALSE,TRUE,TRUE,FALSE,NA
"'PTDSS2","+",15,3,23,8,29,26,16,7,6,2,1,0.6,"",FALSE,TRUE,TRUE,FALSE,NA
"'XPO7","+",11,6,15,8,16,30,6,9,6,2,0.193027325346615,0.6,"",FALSE,TRUE,TRUE,FALSE,NA
"'GRB2","-",28,12,74,37,98,91,39,35,23,14,0.418860749133,0.598901098901099,"",TRUE,TRUE,TRUE,FALSE,NA
"'MTOR","-",19,6,36,22,42,63,19,17,16,6,0.171250765877184,0.598765432098765,"MTOR-AS1, ANGPTL7",TRUE,TRUE,TRUE,FALSE,NA
"'GIMAP8","+",8,5,10,8,12,34,4,6,6,2,0.187988482106129,0.598039215686274,"",FALSE,TRUE,TRUE,FALSE,NA
"'POT1","-",19,11,24,21,25,64,14,10,17,4,0.121220483103637,0.595394736842105,"POT1-AS1",FALSE,TRUE,TRUE,FALSE,NA
"'RAVER1","-",10,3,17,5,21,28,9,8,3,2,1,0.595238095238095,"",FALSE,TRUE,TRUE,FALSE,NA
"'GALC","-",10,5,13,10,16,25,9,4,8,2,0.660019614253024,0.595,"",FALSE,TRUE,TRUE,FALSE,NA
"'ITGAL","+",18,9,52,20,54,46,25,27,17,3,0.00677534903584079,0.594202898550725,"MIR4518",FALSE,TRUE,TRUE,FALSE,NA
"'CDK11B","-",11,5,20,15,20,56,9,11,13,2,0.015778804146314,0.594155844155844,"",TRUE,TRUE,TRUE,TRUE,1.38675131315115
"'VAV1","+",28,14,117,91,137,229,70,47,48,43,0.326083572044766,0.593613537117905,"",TRUE,TRUE,TRUE,TRUE,6.6848152464621
"'RAB6A","-",14,10,25,16,27,40,14,11,13,3,0.17612960333391,0.592857142857143,"",FALSE,TRUE,TRUE,FALSE,NA
"'RRP15","+",5,4,5,8,5,22,1,4,4,4,0.564879564879565,0.590909090909091,"",FALSE,TRUE,TRUE,FALSE,NA
"'PPAN","+",13,7,17,11,19,33,7,10,8,3,0.136733137190803,0.590909090909091,"PPAN-P2RY11, SNORD105, SNORD105B, P2RY11",FALSE,TRUE,TRUE,FALSE,NA
"'PPAN-P2RY11","+",14,7,18,11,20,33,8,10,8,3,0.249034129551765,0.590909090909091,"PPAN, SNORD105, SNORD105B, P2RY11, EIF3G",FALSE,TRUE,TRUE,FALSE,NA
"'SEC14L1","+",22,10,41,25,49,76,20,21,15,10,0.450091382726175,0.589912280701754,"SNHG20, SCARNA16, MIR6516",FALSE,TRUE,TRUE,FALSE,NA
"'LOC101927151","+",1,3,1,6,2,42,1,0,1,5,0.285714285714286,0.587301587301587,"LINC00662",FALSE,TRUE,TRUE,FALSE,NA
"'SNRPA","+",4,5,6,11,6,30,3,3,7,4,0.643665158371041,0.586666666666667,"",FALSE,TRUE,TRUE,FALSE,NA
"'GPC6","+",5,3,7,6,8,27,2,5,2,4,1,0.58641975308642,"GPC6-AS2, GPC6-AS1",FALSE,TRUE,TRUE,FALSE,NA
"'ST13","-",13,11,29,26,30,68,15,14,19,7,0.164312615080245,0.58578431372549,"",TRUE,TRUE,TRUE,FALSE,NA
"'BCAP31","-",10,3,15,6,21,24,8,7,3,3,1,0.583333333333333,"",FALSE,TRUE,TRUE,FALSE,NA
"'SYNE1","-",16,7,19,17,24,46,11,8,10,7,1,0.580745341614907,"ESR1, SYNE1-AS1",TRUE,TRUE,TRUE,FALSE,NA
"'CHD8","-",7,7,12,15,15,58,6,6,12,3,0.126620900076278,0.579937304075235,"SNORD9, SNORD8",FALSE,TRUE,TRUE,FALSE,NA
"'HSF2","+",5,8,5,18,5,45,3,2,13,5,0.621385479509049,0.579365079365079,"",FALSE,TRUE,TRUE,FALSE,NA
"'AKAP13","+",16,12,36,39,38,91,24,12,24,15,0.810079736045613,0.578862314156432,"MIR7706",TRUE,TRUE,TRUE,FALSE,NA
"'XRN1","-",14,9,23,23,25,63,14,9,17,6,0.530213778724839,0.57703081232493,"",FALSE,TRUE,TRUE,FALSE,NA
"'RAB11FIP2","-",3,9,4,14,4,38,2,2,12,2,0.197058823529412,0.574561403508772,"CASC2",FALSE,TRUE,TRUE,FALSE,NA
"'TNIP3","-",7,3,10,5,10,17,7,3,2,3,0.328671328671329,0.573529411764706,"",FALSE,TRUE,TRUE,FALSE,NA
"'IFNGR2","+",0,1,0,9,0,141,0,0,9,0,1,0.572104018912529,"TMEM50B",TRUE,TRUE,TRUE,FALSE,NA
"'SF1","-",25,13,70,59,81,156,35,35,39,20,0.0757168766092471,0.572051282051283,"",FALSE,FALSE,TRUE,TRUE,1.7156755749714
"'FRYL","-",18,10,35,26,41,61,17,18,19,7,0.0687818018521991,0.57172131147541,"",TRUE,TRUE,TRUE,FALSE,NA
"'LNPEP","+",9,5,16,9,18,23,8,8,7,2,0.22896266474137,0.571428571428571,"",TRUE,TRUE,TRUE,FALSE,NA
"'UBAP2L","+",20,12,38,39,43,94,20,18,32,7,0.00761459063299301,0.571339173967459,"C1orf43, SNORA58B",FALSE,TRUE,TRUE,TRUE,0.527246214813246
"'KIAA1109","+",20,9,30,29,30,73,22,8,22,7,1,0.570958904109589,"",FALSE,TRUE,TRUE,TRUE,7.37708828089312
"'RABEP1","+",25,14,87,51,96,117,45,42,29,22,0.598906242158614,0.569420702754035,"NUP88",TRUE,TRUE,TRUE,FALSE,NA
"'ZNF384","-",15,7,30,15,34,35,18,12,6,9,0.226342511798022,0.569047619047619,"",TRUE,TRUE,TRUE,FALSE,NA
"'MAN1B1","+",15,11,36,39,37,93,18,18,32,7,0.00640121109344201,0.568158168574402,"",FALSE,TRUE,TRUE,FALSE,NA
"'ATAT1","+",16,5,16,5,16,17,9,7,4,1,0.606467148262814,0.564705882352941,"",FALSE,TRUE,TRUE,FALSE,NA
"'ZNF252P","-",10,4,11,7,14,21,7,4,3,4,0.630467571644042,0.563492063492063,"TMED10P1, ZNF252P-AS1",FALSE,TRUE,TRUE,FALSE,NA
"'SNX2","+",11,3,16,4,19,19,11,5,3,1,1,0.56140350877193,"",FALSE,TRUE,TRUE,FALSE,NA
"'LRMP","+",7,6,13,10,15,28,5,8,4,6,1,0.557142857142857,"LOC645177, CASC1",TRUE,TRUE,TRUE,FALSE,NA
"'ABCC4","-",8,4,11,8,12,18,5,6,6,2,0.352067952687148,0.555555555555556,"SNORD13G",FALSE,TRUE,TRUE,FALSE,NA
"'ZNF317","+",6,4,7,10,10,44,2,5,2,8,1,0.554545454545455,"",FALSE,TRUE,TRUE,FALSE,NA
"'AKAP9","+",14,4,17,15,20,56,9,8,12,3,0.147464977188825,0.551587301587301,"",TRUE,TRUE,TRUE,FALSE,NA
"'TMEM64","-",4,3,5,4,5,15,2,3,4,0,0.166666666666667,0.55,"",FALSE,TRUE,TRUE,FALSE,NA
"'CDC73","+",14,7,17,27,19,65,8,9,16,11,0.538513744756643,0.549832775919732,"MIR1278, B3GALT2",TRUE,TRUE,TRUE,FALSE,NA
"'ARNT","-",20,8,41,16,45,43,26,15,9,7,0.763438882166565,0.547406082289803,"",TRUE,TRUE,TRUE,FALSE,NA
"'PTAR1","-",7,2,9,6,11,17,6,3,5,1,0.604395604395604,0.544117647058824,"",FALSE,TRUE,TRUE,FALSE,NA
"'GSK3B","-",14,6,24,18,27,39,7,17,13,5,0.0116155256446637,0.543269230769231,"",TRUE,TRUE,TRUE,FALSE,NA
"'ALKBH8","-",4,6,5,11,7,25,0,5,8,3,0.0256410256410256,0.542222222222222,"",FALSE,TRUE,TRUE,FALSE,NA
"'LTA4H","-",1,4,1,4,1,19,0,1,1,3,1,0.539473684210526,"",FALSE,TRUE,TRUE,FALSE,NA
"'SRRM2","+",21,12,37,33,42,85,18,19,25,8,0.027323810352289,0.538742393509128,"SRRM2-AS1",FALSE,TRUE,TRUE,FALSE,NA
"'CRAMP1","+",28,14,91,61,110,141,41,50,40,21,0.0138073313502985,0.53745970341715,"",FALSE,TRUE,TRUE,FALSE,NA
"'SAE1","+",21,14,71,34,82,75,33,38,28,6,0.000616062666045201,0.53505376344086,"",FALSE,TRUE,TRUE,FALSE,NA
"'FOXK2","+",22,11,62,21,72,49,27,35,11,10,0.613407924592836,0.533673469387755,"",FALSE,TRUE,TRUE,FALSE,NA
"'KIF20B","+",7,9,9,15,9,32,6,3,9,6,1,0.533653846153846,"",FALSE,FALSE,TRUE,TRUE,3.01901398030427
"'DIP2A","+",28,14,96,47,109,98,52,44,29,18,0.473246354563812,0.531110004977601,"DIP2A-IT1",FALSE,TRUE,TRUE,FALSE,NA
"'KIAA1468","+",16,10,29,23,29,54,11,18,20,3,0.000511541821953944,0.529100529100529,"",FALSE,TRUE,TRUE,FALSE,NA
"'DPYD","-",29,14,72,40,88,90,32,40,17,23,1,0.528395061728395,"DPYD-AS1, DPYD-AS2",FALSE,TRUE,TRUE,FALSE,NA
"'SEC16A","-",31,15,117,61,146,136,58,59,44,17,0.00418769919102613,0.525997899159664,"C9orf163",FALSE,TRUE,TRUE,FALSE,NA
"'HS2ST1","+",7,5,8,13,8,33,3,5,9,4,0.203095975232198,0.523415977961432,"",FALSE,TRUE,TRUE,FALSE,NA
"'ATP5B","-",8,5,10,8,10,29,4,6,6,2,0.187988482106129,0.522988505747126,"SNORD59B, SNORD59A",FALSE,FALSE,TRUE,TRUE,1.21234367547959
"'RTTN","-",17,9,29,22,33,45,16,13,10,12,0.577085806897022,0.520833333333333,"",FALSE,TRUE,TRUE,FALSE,NA
"'FBXO8","-",15,6,23,13,24,29,15,8,10,3,0.708246155340149,0.52037617554859,"CEP44",FALSE,TRUE,TRUE,FALSE,NA
"'DPH7","-",8,3,14,4,16,13,10,4,3,1,1,0.519230769230769,"",FALSE,TRUE,TRUE,FALSE,NA
"'SRP72","+",4,4,5,5,5,13,3,2,5,0,0.444444444444444,0.519230769230769,"",FALSE,TRUE,TRUE,FALSE,NA
"'MSN","+",2,3,6,4,6,27,4,2,4,0,0.466666666666667,0.518518518518518,"",TRUE,TRUE,TRUE,FALSE,NA
"'INPP5B","-",6,4,7,6,9,20,4,3,4,2,1,0.516666666666667,"",FALSE,TRUE,TRUE,FALSE,NA
"'PAFAH1B1","+",21,14,72,41,87,84,44,28,30,11,0.221997626782994,0.514157014157014,"",FALSE,TRUE,TRUE,FALSE,NA
"'CAPS2","-",4,3,4,4,4,13,1,3,2,2,1,0.512820512820513,"GLIPR1L1",FALSE,TRUE,TRUE,FALSE,NA
"'COL4A3BP","-",13,5,18,7,22,19,11,7,4,3,1,0.511278195488722,"POLK",FALSE,TRUE,TRUE,FALSE,NA
"'PRRC2A","+",23,7,61,26,73,50,29,32,19,7,0.0352222270459907,0.511111111111111,"SNORA38, MIR6832",FALSE,TRUE,TRUE,FALSE,NA
"'ST3GAL3","+",22,9,45,27,47,51,22,23,20,7,0.0488651925458113,0.507130124777183,"LOC101929592, MIR6079",FALSE,TRUE,TRUE,FALSE,NA
"'NOSIP","-",30,10,164,32,193,67,85,79,20,12,0.333680975370577,0.506499759268175,"",FALSE,TRUE,TRUE,FALSE,NA
"'BLM","+",16,6,60,23,65,45,34,26,14,9,0.806899076089321,0.505263157894737,"",TRUE,TRUE,TRUE,FALSE,NA
"'UBR3","+",7,7,14,17,14,36,7,7,15,2,0.0438716125808064,0.50462962962963,"",FALSE,TRUE,TRUE,FALSE,NA
"'SNORD59B","-",8,4,10,7,10,27,4,6,6,1,0.13399835458659,0.503703703703704,"ATP5B",FALSE,FALSE,FALSE,TRUE,1.21234367547959
"'ZNF251","-",33,11,132,62,167,133,68,64,32,30,1,0.503050078025252,"",FALSE,TRUE,TRUE,FALSE,NA
"'WDR82","-",22,10,45,32,56,60,22,23,26,6,0.0045033553485224,0.502666666666666,"MIRLET7G",TRUE,TRUE,TRUE,FALSE,NA
"'GUF1","+",14,6,16,10,21,23,5,11,7,3,0.10537084398977,0.502415458937198,"",FALSE,TRUE,TRUE,FALSE,NA
"'HN1L","+",30,16,147,91,175,179,66,81,68,23,0.00000770705584259444,0.500572983813207,"",FALSE,TRUE,TRUE,TRUE,6.85404591559336
"'COLGALT1","+",12,6,20,11,25,28,8,12,8,3,0.135051828924247,0.5,"",FALSE,TRUE,TRUE,FALSE,NA
"'RASA3","-",5,2,7,5,10,16,5,2,1,4,0.242424242424243,0.5,"",TRUE,TRUE,TRUE,FALSE,NA
"'PAXBP1","-",6,4,7,6,7,15,4,3,4,2,1,0.5,"PAXBP1-AS1",FALSE,TRUE,TRUE,FALSE,NA
"'ZMYM2","+",14,7,20,11,27,28,10,10,11,0,0.00489755122438781,0.5,"",TRUE,TRUE,TRUE,FALSE,NA
"'NABP1","+",3,4,4,5,4,12,2,2,0,5,0.166666666666667,0.5,"",FALSE,TRUE,TRUE,FALSE,NA
"'AK5","+",4,5,5,9,5,22,2,3,7,2,0.265734265734266,0.5,"",FALSE,TRUE,TRUE,FALSE,NA
"'SCLT1","-",14,9,18,17,23,38,13,5,8,9,0.175583176153858,0.497975708502024,"",TRUE,TRUE,TRUE,FALSE,NA
"'GNB1","-",31,16,132,61,152,120,59,73,38,23,0.0299638654886201,0.494968553459119,"",FALSE,TRUE,TRUE,FALSE,NA
"'MAST2","+",15,6,24,7,32,18,18,6,4,3,0.384105416274493,0.492063492063492,"",FALSE,TRUE,TRUE,FALSE,NA
"'NEMP1","-",11,9,29,15,31,31,14,15,13,2,0.0212798876309427,0.491315136476427,"",FALSE,TRUE,TRUE,FALSE,NA
"'PSMD13","+",24,14,90,58,103,112,50,40,43,15,0.024579766795648,0.491071428571429,"",FALSE,TRUE,TRUE,FALSE,NA
"'LINC01473","-",0,2,0,3,0,90,0,0,3,0,1,0.488888888888889,"",FALSE,TRUE,TRUE,FALSE,NA
"'ZW10","-",3,3,4,4,4,15,3,1,4,0,1,0.488888888888889,"",FALSE,TRUE,TRUE,FALSE,NA
"'VPS13A","+",15,8,32,18,33,39,15,17,13,5,0.137343075222174,0.488888888888888,"VPS13A-AS1",FALSE,TRUE,TRUE,FALSE,NA
"'ATE1","-",6,7,6,13,7,28,4,2,3,10,0.12874097007224,0.487012987012987,"ATE1-AS1",FALSE,TRUE,TRUE,FALSE,NA
"'GAS2","+",5,3,6,4,7,19,5,1,1,3,0.190476190476191,0.486842105263158,"",FALSE,TRUE,TRUE,FALSE,NA
"'SNORD59A","-",6,5,8,7,8,28,3,5,5,2,0.314685314685315,0.485714285714286,"ATP5B",FALSE,FALSE,FALSE,TRUE,1.21234367547959
"'KIAA0586","+",12,6,14,10,17,20,9,5,7,3,1,0.485714285714286,"TIMM9",FALSE,TRUE,TRUE,FALSE,NA
"'RNF169","+",5,6,5,10,5,20,3,2,8,2,0.56043956043956,0.485714285714286,"XRRA1",FALSE,TRUE,TRUE,FALSE,NA
"'NF1","+",15,13,49,34,52,67,27,22,27,7,0.0343925615338164,0.48435243139143,"OMG, EVI2B, EVI2A",TRUE,TRUE,TRUE,FALSE,NA
"'ZNF34","-",25,12,80,35,124,81,39,41,25,10,0.0267118968708883,0.482638888888889,"",FALSE,TRUE,TRUE,FALSE,NA
"'SUSD6","+",8,6,13,9,15,16,7,6,5,4,1,0.482142857142857,"",FALSE,TRUE,TRUE,FALSE,NA
"'RASEF","-",0,2,0,5,0,54,0,0,1,4,1,0.481481481481482,"",FALSE,TRUE,TRUE,FALSE,NA
"'DSE","+",3,4,3,4,5,13,1,2,2,2,1,0.480769230769231,"TSPYL1",FALSE,TRUE,TRUE,FALSE,NA
"'IL12RB1","-",13,3,20,7,28,20,8,12,4,3,0.661835748792271,0.48,"MAST3",FALSE,TRUE,TRUE,FALSE,NA
"'RFC1","-",7,5,13,8,17,25,5,8,7,1,0.0668730650154799,0.48,"",FALSE,TRUE,TRUE,FALSE,NA
"'MAP4K3","-",17,8,20,16,22,32,11,9,10,6,0.741177798197675,0.479166666666667,"",FALSE,TRUE,TRUE,FALSE,NA
"'SAPCD1","+",2,2,2,3,2,45,1,1,3,0,0.4,0.477777777777778,"MSH5-SAPCD1, SAPCD1-AS1",FALSE,TRUE,TRUE,FALSE,NA
"'CRTAP","+",1,2,1,4,1,44,0,1,4,0,0.2,0.477272727272727,"",FALSE,TRUE,TRUE,FALSE,NA
"'MCF2L2","-",4,2,5,5,6,11,4,1,4,1,1,0.477272727272727,"B3GNT5",FALSE,TRUE,TRUE,FALSE,NA
"'PHYKPL","-",7,5,13,8,21,18,7,6,7,1,0.173581011351909,0.476190476190476,"HNRNPAB",FALSE,TRUE,TRUE,FALSE,NA
"'CPSF2","+",5,5,5,8,5,14,4,1,7,1,1,0.476190476190476,"",FALSE,TRUE,TRUE,FALSE,NA
"'USP14","+",7,4,8,9,8,20,2,6,7,2,0.0566844919786096,0.475,"",FALSE,TRUE,TRUE,FALSE,NA
"'ANKRD36","+",10,8,14,12,14,25,9,5,5,7,0.431239736169067,0.472727272727273,"",FALSE,TRUE,TRUE,FALSE,NA
"'HSDL1","-",4,2,4,6,6,33,2,2,0,6,0.133333333333333,0.46969696969697,"",FALSE,TRUE,TRUE,FALSE,NA
"'SPPL3","-",19,7,46,18,49,36,21,25,6,12,0.412598970515373,0.46875,"",TRUE,TRUE,TRUE,FALSE,NA
"'ZGRF1","-",4,4,4,5,4,18,1,3,2,3,1,0.466666666666667,"LARP7",FALSE,TRUE,TRUE,FALSE,NA
"'LOC101927817","+",14,9,20,11,21,23,10,10,5,6,1,0.466403162055336,"ANKRD11",FALSE,TRUE,TRUE,FALSE,NA
"'FANCA","-",35,20,234,157,259,300,131,103,108,49,0.0113205198728837,0.465680751173711,"ZNF276",TRUE,TRUE,TRUE,TRUE,0.00312821417411986
"'ANKRD11","-",25,15,85,53,92,103,46,39,24,29,0.381948906736529,0.464271844660194,"LOC105371414, LOC100287036, LOC101927817",FALSE,TRUE,TRUE,FALSE,NA
"'FXR2","-",27,15,53,43,65,82,30,23,36,7,0.00732891716947154,0.464056482670089,"SHBG",FALSE,TRUE,TRUE,TRUE,1.81584727546735
"'STXBP5","+",13,11,26,24,31,44,14,12,12,12,1,0.463203463203463,"STXBP5-AS1",FALSE,TRUE,TRUE,FALSE,NA
"'FARP2","+",13,4,14,8,17,18,4,10,4,4,0.386446508427933,0.462962962962963,"MIR3133, STK25",FALSE,TRUE,TRUE,FALSE,NA
"'USP15","+",17,12,36,31,40,57,23,13,24,7,0.288668269317542,0.462189957652752,"MIR6125",TRUE,TRUE,TRUE,FALSE,NA
"'FUNDC2","+",6,6,8,16,10,26,2,6,11,5,0.0824696011127562,0.461538461538461,"",FALSE,FALSE,TRUE,TRUE,0.980038544139147
"'CHD4","-",20,12,47,37,58,70,25,22,24,13,0.373160460737429,0.458874458874458,"SCARNA11",FALSE,TRUE,TRUE,FALSE,NA
"'POLQ","-",7,5,8,10,9,16,6,2,10,0,0.183006535947712,0.458333333333333,"",FALSE,TRUE,TRUE,FALSE,NA
"'ZNF804A","+",0,2,0,6,0,16,0,0,3,3,1,0.458333333333333,"",FALSE,TRUE,TRUE,FALSE,NA
"'DNMT1","-",33,14,185,83,233,167,100,85,61,22,0.0029562101903449,0.457112801424179,"",TRUE,TRUE,TRUE,FALSE,NA
"'LINC00924","+",0,1,0,3,0,22,0,0,2,1,1,0.454545454545455,"",FALSE,TRUE,TRUE,FALSE,NA
"'NELFA","-",0,2,0,3,0,22,0,0,3,0,1,0.454545454545455,"MIR943",FALSE,TRUE,TRUE,FALSE,NA
"'PIK3CA","+",17,5,22,9,23,17,13,9,7,2,0.428984267171625,0.453781512605042,"KCNMB3",TRUE,TRUE,TRUE,FALSE,NA
"'GTDC1","-",7,7,14,21,15,39,5,9,16,5,0.0331669502492156,0.451566951566952,"LOC101928386",FALSE,TRUE,TRUE,FALSE,NA
"'KLF12","-",22,12,48,42,51,76,23,25,26,16,0.208360616754398,0.451523545706371,"",FALSE,TRUE,TRUE,FALSE,NA
"'ZCCHC11","-",15,7,38,19,41,37,21,17,11,8,1,0.451013513513513,"",FALSE,TRUE,TRUE,FALSE,NA
"'HNRNPUL2-BSCL2","-",25,11,68,37,78,88,33,35,32,5,0.000124946885311527,0.450757575757576,"BSCL2, GNG3, HNRNPUL2",FALSE,TRUE,TRUE,TRUE,0.0133751975511847
"'PIAS1","+",13,11,23,30,25,50,15,8,20,10,1,0.45,"CALML4",FALSE,TRUE,TRUE,FALSE,NA
"'MIR5096","+",21,12,63,28,70,53,25,38,3,25,0.00642995536780623,0.448899371069182,"SPEN, GNG4, LYST, BMP2K, ZZEF1, CYB5D2, ANKFY1, LGALS1, NOL12, TRIOBP, H1F0, GCAT, GALR3, ANKRD54, MIR658, MIR659, EIF3L, MICALL1, C22orf23, POLR2F, MIR6820, SOX10, MIR4534",FALSE,TRUE,TRUE,TRUE,1.7740421349779
"'DUSP16","-",11,4,21,6,23,13,8,13,5,1,0.0768115942028986,0.448717948717949,"",FALSE,TRUE,TRUE,FALSE,NA
"'HNRNPUL2","-",24,11,66,36,76,87,32,34,31,5,0.000228237782613697,0.44867221561633,"HNRNPUL2-BSCL2",FALSE,TRUE,TRUE,TRUE,0.0133751975511847
"'UBE2R2","+",16,6,27,14,30,23,14,13,11,3,0.17612960333391,0.447826086956522,"",FALSE,TRUE,TRUE,FALSE,NA
"'NT5DC1","+",10,4,10,14,11,42,6,4,10,4,0.673352178399964,0.447619047619048,"COL10A1",FALSE,TRUE,TRUE,FALSE,NA
"'CBFB","+",28,16,70,73,83,137,34,36,52,21,0.0065394412301783,0.444444444444445,"",TRUE,TRUE,TRUE,TRUE,0.135692498071137
"'LASP1","+",15,4,28,9,29,18,13,15,8,1,0.0501101173743979,0.444444444444444,"MIR6779",TRUE,TRUE,TRUE,FALSE,NA
"'PGD","+",0,2,0,3,0,12,0,0,1,2,1,0.444444444444444,"",FALSE,TRUE,TRUE,FALSE,NA
"'ATF7IP","+",22,14,47,34,53,65,20,27,23,11,0.0416563740029377,0.443589743589744,"",TRUE,TRUE,TRUE,FALSE,NA
"'CSNK1G1","-",15,5,23,11,25,21,11,12,6,5,1,0.442857142857143,"",FALSE,TRUE,TRUE,FALSE,NA
"'CAMK2D","-",20,10,38,31,48,58,13,25,28,3,0.00000177597278989623,0.442528735632184,"",TRUE,TRUE,TRUE,FALSE,NA
"'SETD2","-",30,14,83,51,91,93,41,42,40,11,0.00100358927429179,0.4424616792496,"",TRUE,TRUE,TRUE,FALSE,NA
"'MIA2","+",13,8,20,20,24,37,12,8,14,6,0.741053623144835,0.441971383147854,"LOC100288846",FALSE,TRUE,TRUE,FALSE,NA
"'UBR2","+",27,15,86,41,99,77,42,44,30,11,0.0125889582502798,0.440892440892441,"",FALSE,TRUE,TRUE,FALSE,NA
"'NAA38","-",25,9,102,37,115,68,56,46,22,15,0.701061502362007,0.440311418685122,"CYB5D1, CHD3",FALSE,TRUE,TRUE,FALSE,NA
"'CENPC","-",13,3,17,8,18,31,9,8,7,1,0.182192635739547,0.438709677419355,"",FALSE,TRUE,TRUE,FALSE,NA
"'PIAS2","-",9,3,10,4,12,16,7,3,3,1,1,0.4375,"",FALSE,TRUE,TRUE,FALSE,NA
"'WDR62","+",17,8,34,19,37,34,19,15,14,5,0.246862413409973,0.43598615916955,"",FALSE,TRUE,TRUE,FALSE,NA
"'RNF157","-",28,15,189,95,219,162,92,97,68,27,0.000237688195300354,0.434722222222222,"RNF157-AS1",TRUE,TRUE,TRUE,FALSE,NA
"'TBC1D23","+",5,2,6,3,6,15,1,5,3,0,0.0476190476190476,0.433333333333333,"",FALSE,TRUE,TRUE,FALSE,NA
"'ATAD3B","+",20,5,28,11,32,18,11,17,5,6,0.733788293298861,0.432098765432099,"",FALSE,FALSE,TRUE,TRUE,1.38675131315115
"'LOC102724064","+",4,6,5,9,5,22,3,2,8,1,0.505494505494505,0.431818181818182,"SLC29A2",FALSE,TRUE,TRUE,FALSE,NA
"'AP2A2","+",18,8,43,15,46,31,25,18,7,8,0.550405638390495,0.43010752688172,"",FALSE,TRUE,TRUE,FALSE,NA
"'RRN3","-",11,9,17,12,19,25,7,10,10,2,0.0534752673788419,0.43,"PDXDC1",FALSE,TRUE,TRUE,FALSE,NA
"'COX6B1","+",19,10,35,22,39,39,18,17,15,7,0.274761200021348,0.428774928774929,"",FALSE,TRUE,TRUE,FALSE,NA
"'ANXA1","+",7,7,8,16,10,28,4,4,14,2,0.128770542958186,0.428571428571429,"",TRUE,FALSE,TRUE,TRUE,7.26892786544384
"'CDC23","-",2,2,3,2,3,14,1,2,1,1,1,0.428571428571429,"KIF20A",FALSE,TRUE,TRUE,FALSE,NA
"'PCM1","+",19,9,31,29,36,64,12,19,25,4,0.000186315596396519,0.42824074074074,"",TRUE,TRUE,TRUE,TRUE,3.68541460324469
"'PCCA","+",13,10,19,14,25,26,10,9,8,6,1,0.42603550295858,"PCCA-AS1, GGACT",FALSE,TRUE,TRUE,FALSE,NA
"'SYNRG","-",22,10,70,43,81,70,29,41,37,6,0.00000201148035827536,0.425396825396826,"",FALSE,TRUE,TRUE,FALSE,NA
"'MRPS10","-",2,3,3,3,4,11,1,2,3,0,0.4,0.424242424242424,"",FALSE,TRUE,TRUE,FALSE,NA
"'RABL6","+",22,11,87,29,100,61,45,42,12,17,0.394033988551497,0.423968343697005,"CCDC183-AS1, MIR4292",FALSE,TRUE,TRUE,FALSE,NA
"'FLYWCH2","+",4,2,6,7,8,17,3,3,5,2,0.592074592074592,0.423529411764706,"",FALSE,TRUE,TRUE,FALSE,NA
"'C11orf65","-",10,10,19,15,19,28,10,9,3,12,0.0789911495864971,0.423469387755102,"ATM",FALSE,FALSE,TRUE,TRUE,7.37708828089312
"'TRAPPC10","+",31,16,101,51,112,99,48,53,37,14,0.00350086680711348,0.42334455667789,"",FALSE,TRUE,TRUE,FALSE,NA
"'ANKFY1","-",22,12,66,28,73,50,41,25,25,3,0.012486888539216,0.4224,"MIR5096",FALSE,TRUE,TRUE,TRUE,1.7740421349779
"'NCOA2","-",19,8,41,28,48,48,19,22,19,9,0.0904067336873811,0.42,"",TRUE,TRUE,TRUE,FALSE,NA
"'ITPKB","-",13,3,21,7,28,25,11,10,4,3,1,0.42,"ITPKB-IT1",FALSE,TRUE,TRUE,FALSE,NA
"'SAFB","+",26,13,97,48,126,87,47,50,39,9,0.000148060446492707,0.415836526181353,"",FALSE,TRUE,TRUE,FALSE,NA
"'XYLT1","-",15,3,34,11,36,19,11,23,7,4,0.0856770669141927,0.41578947368421,"LOC102723692",FALSE,TRUE,TRUE,FALSE,NA
"'TIMELESS","-",13,4,20,11,25,23,9,11,11,0,0.00210967421878096,0.415458937198067,"",FALSE,FALSE,TRUE,TRUE,6.6848152464621
"'BAZ2A","-",13,6,23,10,25,21,12,11,4,6,0.707985303535915,0.410714285714286,"RBMS2",FALSE,TRUE,TRUE,TRUE,1.21234367547959
"'LPP","+",19,12,37,30,41,54,24,13,15,15,0.319264851700421,0.410256410256411,"LPP-AS2, FLJ42393, LPP-AS1, MIR28",TRUE,TRUE,TRUE,FALSE,NA
"'RBL2","+",9,8,11,13,11,24,4,7,7,6,0.444188316058689,0.409722222222222,"AKTIP",TRUE,TRUE,TRUE,FALSE,NA
"'KIF1B","+",18,8,31,20,37,36,15,16,13,7,0.267208937943663,0.409356725146199,"MIR1273D, RNU6-1, RNU6-9, RNU6-7, RNU6-8, RNU6-2",FALSE,TRUE,TRUE,FALSE,NA
"'BUB1B","+",8,7,16,12,18,20,10,6,7,5,1,0.409090909090909,"BUB1B-PAK6",TRUE,TRUE,TRUE,FALSE,NA
"'FBXW11","-",11,5,16,8,16,15,10,6,6,2,0.667413127098145,0.408333333333333,"",FALSE,TRUE,TRUE,FALSE,NA
"'TONSL","-",18,9,45,18,50,34,16,29,16,2,0.000175867741193973,0.408304498269896,"TONSL-AS1, MIR6893",FALSE,TRUE,TRUE,FALSE,NA
"'POLH","+",17,7,26,20,34,34,12,14,12,8,0.388002343481331,0.408304498269896,"GTPBP2",TRUE,TRUE,TRUE,FALSE,NA
"'PPP4R3B","-",10,7,16,13,19,25,10,6,5,8,0.2723034767446,0.406153846153846,"",FALSE,TRUE,TRUE,FALSE,NA
"'RTKN2","-",8,6,13,10,13,17,8,5,6,4,1,0.405228758169935,"",FALSE,TRUE,TRUE,FALSE,NA
"'LUC7L","-",30,17,161,72,185,122,74,87,52,20,0.000209964069978417,0.404846756949395,"",FALSE,TRUE,TRUE,FALSE,NA
"'MACF1","+",32,14,98,39,114,63,50,48,29,10,0.013528330263054,0.404761904761904,"KIAA0754",TRUE,TRUE,TRUE,FALSE,NA
"'SET","+",10,6,16,8,17,17,6,10,8,0,0.00642853355196874,0.403361344537815,"",TRUE,TRUE,TRUE,FALSE,NA
"'STIM1","+",19,10,35,19,41,36,22,13,11,8,0.7753434515204,0.401234567901235,"MIR4687",FALSE,TRUE,TRUE,FALSE,NA
"'MAN1A2","+",10,9,18,20,22,37,7,11,14,6,0.101353991309014,0.401137980085348,"",FALSE,TRUE,TRUE,FALSE,NA
"'MECP2","-",27,13,134,54,151,93,66,68,35,19,0.0748727204008898,0.400313620071683,"",FALSE,TRUE,TRUE,FALSE,NA
"'LPIN2","-",13,5,22,9,32,20,11,11,6,3,0.456403411197627,0.4,"LOC727896",FALSE,TRUE,TRUE,FALSE,NA
"'ITGB3BP","-",5,2,5,4,6,10,1,4,4,0,0.0476190476190477,0.4,"",FALSE,TRUE,TRUE,FALSE,NA
"'LOC100128568","+",5,2,5,2,5,10,2,3,2,0,0.428571428571428,0.4,"RFX2",FALSE,TRUE,TRUE,FALSE,NA
"'FAM160B1","+",8,5,10,5,11,14,6,4,4,1,0.6003996003996,0.4,"",FALSE,TRUE,TRUE,FALSE,NA
"'TXNRD1","+",6,3,7,3,7,10,3,4,2,1,1,0.4,"EID3",FALSE,TRUE,TRUE,FALSE,NA
"'STK17A","+",19,8,29,20,33,41,16,13,8,12,0.386845141437656,0.4,"COA1",FALSE,TRUE,TRUE,FALSE,NA
"'IQGAP1","+",21,11,45,27,47,42,30,15,16,11,0.614945359131381,0.398268398268399,"",FALSE,TRUE,TRUE,FALSE,NA
"'SLC44A2","+",18,8,53,18,57,35,30,23,12,6,0.581752171410662,0.396638655462185,"",FALSE,TRUE,TRUE,FALSE,NA
"'SMG6","-",31,12,178,73,209,123,85,93,42,31,0.167429689387688,0.395825749302269,"LOC101927839",TRUE,TRUE,TRUE,FALSE,NA
"'AHRR","+",16,7,53,9,57,18,33,20,9,0,0.0474727378879163,0.395061728395062,"PDCD6",FALSE,TRUE,TRUE,FALSE,NA
"'RUNX2","+",11,10,21,23,24,43,12,9,6,17,0.0646186368722974,0.394291754756871,"SUPT3H",TRUE,TRUE,TRUE,FALSE,NA
"'PPP3CB","-",16,8,23,8,27,15,10,13,5,3,0.433147942157953,0.391666666666667,"PPP3CB-AS1",FALSE,TRUE,TRUE,FALSE,NA
"'GPATCH2","-",20,7,31,17,35,32,18,13,10,7,1,0.391666666666667,"",FALSE,TRUE,TRUE,FALSE,NA
"'POM121C","-",9,4,13,9,13,19,8,5,3,6,0.386996904024768,0.390977443609023,"NSUN5P1",FALSE,TRUE,TRUE,FALSE,NA
"'EIF3E","-",8,7,9,8,10,16,2,7,6,2,0.0566844919786096,0.390625,"",TRUE,TRUE,TRUE,FALSE,NA
"'MAP4","-",18,9,39,32,47,47,22,17,18,14,1,0.390343698854338,"",TRUE,TRUE,TRUE,FALSE,NA
"'EDEM3","-",7,4,12,9,12,17,4,8,9,0,0.00459973463069439,0.389705882352941,"",FALSE,TRUE,TRUE,FALSE,NA
"'CLEC16A","+",13,11,38,37,48,69,24,14,17,20,0.166948441862027,0.389233954451346,"",FALSE,TRUE,TRUE,FALSE,NA
"'LYPLAL1","+",10,4,15,6,15,12,6,9,4,2,0.361455108359133,0.388888888888889,"",FALSE,TRUE,TRUE,FALSE,NA
"'NUDCD1","-",15,5,22,11,24,20,12,10,8,3,0.455860779287775,0.388888888888889,"",FALSE,TRUE,TRUE,FALSE,NA
"'CRKL","+",10,6,16,11,17,20,8,8,10,1,0.0416710673003579,0.388888888888889,"",TRUE,TRUE,TRUE,FALSE,NA
"'ABCD2","-",14,8,20,29,27,46,13,7,18,11,1,0.386086956521739,"",FALSE,FALSE,TRUE,TRUE,3.65462575351225
"'ZNF778","+",3,4,3,9,8,19,3,0,7,2,1,0.385964912280702,"",FALSE,TRUE,TRUE,FALSE,NA
"'TCF25","+",18,7,40,17,49,30,28,12,12,5,1,0.385714285714286,"",FALSE,TRUE,TRUE,FALSE,NA
"'RAB11FIP3","+",30,13,116,42,129,66,53,63,19,23,1,0.381654381654381,"",FALSE,TRUE,TRUE,FALSE,NA
"'EPB41","+",18,14,51,47,52,80,21,30,28,19,0.10528590400319,0.380952380952381,"TMEM200B",FALSE,TRUE,TRUE,FALSE,NA
"'ERI3","-",10,3,11,3,12,7,4,7,2,1,0.538461538461539,0.380952380952381,"ERI3-IT1, SNORA110",FALSE,TRUE,TRUE,FALSE,NA
"'ALOX12P2","+",3,3,5,3,5,7,5,0,3,0,1,0.380952380952381,"",FALSE,TRUE,TRUE,FALSE,NA
"'CTH","+",1,3,1,3,1,7,1,0,2,1,1,0.380952380952381,"",FALSE,TRUE,TRUE,FALSE,NA
"'LINC00536","-",5,3,5,3,5,7,0,5,2,1,0.107142857142857,0.380952380952381,"",FALSE,TRUE,TRUE,FALSE,NA
"'ERP44","-",11,2,14,6,15,14,4,10,5,1,0.0498452012383902,0.380952380952381,"",FALSE,TRUE,TRUE,FALSE,NA
"'ATP8B2","+",3,4,4,7,4,12,2,2,6,1,0.490909090909091,0.375,"",FALSE,FALSE,TRUE,TRUE,0.527246214813246
"'HMGN1","-",0,2,0,3,0,8,0,0,3,0,1,0.375,"",FALSE,FALSE,TRUE,TRUE,3.87869528783106
"'PPA2","-",9,7,11,10,12,16,6,5,6,4,1,0.375,"",FALSE,TRUE,TRUE,FALSE,NA
"'XRCC1","-",14,5,20,9,28,14,9,11,6,3,0.426986506746627,0.375,"",FALSE,TRUE,TRUE,FALSE,NA
"'ANKRD27","-",2,4,2,4,2,8,2,0,2,2,0.466666666666667,0.375,"SNORA68B",FALSE,TRUE,TRUE,FALSE,NA
"'NFKB1","+",11,7,14,12,14,22,8,6,10,2,0.216384439359268,0.371900826446281,"LOC105377621",TRUE,TRUE,TRUE,FALSE,NA
"'SLC3A2","+",13,9,26,15,30,28,12,14,11,4,0.113825751604177,0.371428571428571,"",FALSE,TRUE,TRUE,FALSE,NA
"'PRPF6","+",20,11,63,39,69,68,33,30,27,12,0.102761949198256,0.371224165341812,"",FALSE,TRUE,TRUE,FALSE,NA
"'RBMS1","-",8,8,10,13,10,21,4,6,9,4,0.221544910870527,0.369047619047619,"MIR4785",FALSE,TRUE,TRUE,FALSE,NA
"'MRE11","-",6,4,8,5,9,12,2,6,2,3,1,0.366666666666667,"MIR548L",TRUE,TRUE,TRUE,FALSE,NA
"'BRWD1","-",14,10,25,27,30,38,11,14,24,3,0.000901821951531707,0.366028708133971,"",FALSE,FALSE,TRUE,TRUE,3.87869528783106
"'RBM14-RBM4","+",18,7,42,13,51,21,26,16,10,3,0.506081182545575,0.363636363636364,"RBM14, RBM4",FALSE,TRUE,TRUE,FALSE,NA
"'TAOK1","+",26,12,64,38,78,66,34,30,29,9,0.0220294497392058,0.362718089990818,"",FALSE,TRUE,TRUE,FALSE,NA
"'OLA1","-",5,5,6,10,6,19,3,3,5,5,1,0.361842105263158,"",FALSE,TRUE,TRUE,FALSE,NA
"'LINC01599","-",5,4,7,4,7,9,5,2,3,1,1,0.361111111111111,"LINC01588",FALSE,TRUE,TRUE,FALSE,NA
"'OTUD7B","-",7,4,8,6,8,12,6,2,2,4,0.277389277389277,0.361111111111111,"",FALSE,TRUE,TRUE,FALSE,NA
"'TENM1","-",10,6,17,9,17,17,9,8,5,4,1,0.360294117647059,"",FALSE,TRUE,TRUE,FALSE,NA
"'CTNNB1","+",3,2,4,5,4,10,2,2,2,3,1,0.36,"",TRUE,TRUE,TRUE,FALSE,NA
"'YBX1","+",8,7,10,12,10,20,6,4,2,10,0.0743034055727554,0.36,"",TRUE,TRUE,TRUE,FALSE,NA
"'ROCK2","-",8,7,9,9,9,15,2,7,7,2,0.0566844919786096,0.358333333333333,"",FALSE,TRUE,TRUE,FALSE,NA
"'POLDIP3","-",13,6,27,8,31,15,14,13,7,1,0.107798028706882,0.358333333333333,"",FALSE,TRUE,TRUE,FALSE,NA
"'PRNP","+",2,2,3,3,3,14,0,3,2,1,0.4,0.357142857142857,"",FALSE,TRUE,TRUE,FALSE,NA
"'LOC100288637","+",5,2,6,2,6,7,2,4,2,0,0.428571428571429,0.357142857142857,"OTUD7A, CHRNA7, LINC02249, GOLGA8H, GOLGA8K, GOLGA8T, ULK4P1, ULK4P2",FALSE,TRUE,TRUE,FALSE,NA
"'CREB3","+",4,2,4,2,4,7,0,4,2,0,0.0666666666666666,0.357142857142857,"TLN1, MIR6853, GBA2",FALSE,TRUE,TRUE,FALSE,NA
"'ACACB","+",7,2,8,3,9,7,4,4,0,3,0.236363636363636,0.357142857142857,"",FALSE,TRUE,TRUE,FALSE,NA
"'LRSAM1","+",7,5,10,6,10,14,4,6,4,2,0.608391608391609,0.357142857142857,"",FALSE,TRUE,TRUE,FALSE,NA
"'CHD2","+",15,12,25,25,27,42,11,14,21,4,0.00715036611296616,0.356107660455486,"MIR3175",TRUE,FALSE,TRUE,TRUE,2.01427451349403
"'URI1","+",11,9,13,23,15,38,5,8,21,2,0.00134681236231979,0.355889724310776,"",FALSE,FALSE,TRUE,TRUE,0.108139761882509
"'CCDC47","-",19,7,32,12,34,18,17,15,8,4,0.507144600735071,0.355555555555556,"",FALSE,TRUE,TRUE,FALSE,NA
"'SIPA1L3","+",16,4,26,5,38,9,12,14,5,0,0.0482017055988135,0.355555555555556,"SNORD152",FALSE,TRUE,TRUE,FALSE,NA
"'TTC39C","+",9,4,15,9,16,15,3,12,5,4,0.099438319117953,0.355555555555556,"TTC39C-AS1",FALSE,TRUE,TRUE,FALSE,NA
"'SGMS1","-",10,6,16,10,17,17,5,11,6,4,0.227971463184816,0.352941176470588,"",TRUE,TRUE,TRUE,FALSE,NA
"'MIR5096","+",18,6,49,16,58,24,27,22,11,5,0.393156343761361,0.352564102564103,"SPEN, GNG4, LYST, BMP2K, ZZEF1, CYB5D2, ANKFY1, LGALS1, NOL12, TRIOBP, H1F0, GCAT, GALR3, ANKRD54, MIR658, MIR659, EIF3L, MICALL1, C22orf23, POLR2F, MIR6820, SOX10, MIR4534",FALSE,TRUE,TRUE,TRUE,1.7740421349779
"'NPLOC4","-",36,19,499,193,580,299,248,251,135,58,0.00000159657218616366,0.352139708117974,"",FALSE,FALSE,TRUE,TRUE,3.17281497572526
"'ERBIN","+",14,8,23,16,26,24,11,12,7,9,1,0.351190476190476,"LOC100303749",FALSE,TRUE,TRUE,FALSE,NA
"'EP300","+",20,16,59,40,72,61,31,28,27,13,0.151850146793863,0.351092896174863,"",TRUE,TRUE,TRUE,FALSE,NA
"'JMJD1C","-",14,12,25,31,30,50,12,13,15,16,1,0.35,"MIR1296, LOC105378330, JMJD1C-AS1, REEP3",FALSE,FALSE,TRUE,TRUE,5.28304253313552
"'RNF13","+",7,6,9,6,12,11,5,4,2,4,0.608391608391608,0.348484848484848,"",FALSE,TRUE,TRUE,FALSE,NA
"'RBM4","+",20,9,47,15,53,23,23,24,9,6,0.558172564441335,0.347826086956522,"RBM14-RBM4, RBM4B",FALSE,TRUE,TRUE,FALSE,NA
"'CMAS","+",4,2,4,3,5,13,1,3,2,1,0.485714285714286,0.346153846153846,"",FALSE,TRUE,TRUE,FALSE,NA
"'TMEM62","+",5,4,6,6,6,13,1,5,5,1,0.08008658008658,0.346153846153846,"",FALSE,TRUE,TRUE,FALSE,NA
"'POLR2A","+",25,15,91,41,113,63,51,40,31,10,0.0348214721328583,0.346119929453263,"",FALSE,TRUE,TRUE,FALSE,NA
"'TANGO6","+",17,9,34,16,42,27,15,19,4,12,0.228220231858818,0.344907407407407,"",FALSE,TRUE,TRUE,FALSE,NA
"'STAT2","-",7,7,10,9,11,16,3,7,8,1,0.0197666110978804,0.34375,"",FALSE,FALSE,TRUE,TRUE,6.6848152464621
"'N4BP2L2","-",9,5,12,6,17,21,8,4,3,3,0.626696832579186,0.342857142857143,"MINOS1P1, N4BP2L2-IT2",FALSE,TRUE,TRUE,FALSE,NA
"'ATM","+",20,12,40,31,45,47,21,19,20,11,0.342088733569169,0.341892883345562,"C11orf65",TRUE,FALSE,TRUE,TRUE,7.37708828089312
"'KMT5B","-",18,13,56,35,61,56,31,25,21,14,0.827870214349405,0.341517857142857,"",FALSE,TRUE,TRUE,FALSE,NA
"'SP1","+",21,10,57,16,66,25,27,30,9,7,0.58139713974828,0.3375,"",FALSE,TRUE,TRUE,FALSE,NA
"'SACM1L","+",9,8,18,18,18,28,11,7,14,4,0.470522803114572,0.337301587301587,"",FALSE,FALSE,TRUE,TRUE,7.37708828089312
"'NUDT3","-",17,8,35,13,38,21,19,16,9,4,0.512350054161039,0.336996336996337,"RPS10-NUDT3",FALSE,TRUE,TRUE,FALSE,NA
"'EIF2B3","-",26,10,81,18,99,29,44,37,15,3,0.0324299249477892,0.336713995943204,"",FALSE,TRUE,TRUE,FALSE,NA
"'EED","+",9,8,11,16,12,33,3,8,12,4,0.0219918936300684,0.335497835497836,"MIR6755",FALSE,FALSE,TRUE,TRUE,7.37708828089312
"'PDXDC1","+",23,13,50,30,60,45,25,25,16,14,0.820238241700668,0.334156378600823,"MIR1972-2, MIR1972-1, NTAN1, RRN3, LOC100505915, PKD1P6-NPIPP1, MIR6511B1, MIR6511B2",FALSE,TRUE,TRUE,FALSE,NA
"'KCTD1","-",2,2,2,2,2,6,1,1,1,1,1,0.333333333333333,"MIR8057",FALSE,TRUE,TRUE,FALSE,NA
"'ALG10B","+",1,2,1,2,1,6,0,1,2,0,0.333333333333333,0.333333333333333,"",FALSE,TRUE,TRUE,FALSE,NA
"'P2RX5-TAX1BP3","-",0,2,0,2,0,6,0,0,1,1,1,0.333333333333333,"CTNS, TAX1BP3, EMC6, P2RX5",FALSE,TRUE,TRUE,FALSE,NA
"'HRASLS5","-",0,2,0,2,0,6,0,0,1,1,1,0.333333333333333,"",FALSE,TRUE,TRUE,FALSE,NA
"'RMI1","+",3,2,3,3,3,8,2,1,1,2,1,0.333333333333333,"HNRNPK",FALSE,TRUE,TRUE,FALSE,NA
"'TAB1","+",5,3,10,4,13,8,5,5,2,2,1,0.333333333333333,"LOC100506472",FALSE,TRUE,TRUE,FALSE,NA
"'NAA30","+",3,3,3,4,4,10,2,1,4,0,0.428571428571428,0.333333333333333,"",FALSE,TRUE,TRUE,FALSE,NA
"'MPP6","+",7,7,9,9,10,16,5,4,4,5,1,0.333333333333333,"",FALSE,TRUE,TRUE,FALSE,NA
"'GRK3","+",5,3,6,3,7,6,2,4,1,2,1,0.333333333333333,"",FALSE,TRUE,TRUE,FALSE,NA
"'ACAD11","-",5,5,7,6,8,10,3,4,5,1,0.265734265734266,0.333333333333333,"NPHP3-ACAD11, ACKR4, UBA5",FALSE,TRUE,TRUE,FALSE,NA
"'RANBP10","-",12,6,20,7,25,12,8,12,4,3,0.661835748792271,0.333333333333333,"",FALSE,TRUE,TRUE,FALSE,NA
"'COA1","-",19,8,33,21,37,35,16,17,10,11,1,0.330827067669173,"STK17A",FALSE,TRUE,TRUE,FALSE,NA
"'KDM2A","+",35,18,272,106,320,153,139,133,72,34,0.00384606184353367,0.328396606869699,"",FALSE,TRUE,TRUE,FALSE,NA
"'FUT8","+",13,8,28,13,32,22,15,13,4,9,0.200034023008059,0.325757575757576,"FUT8-AS1, MIR625",TRUE,TRUE,TRUE,FALSE,NA
"'ABHD16A","-",19,9,39,10,41,16,21,18,7,3,0.482260829877819,0.325,"MIR4646",FALSE,TRUE,TRUE,FALSE,NA
"'RPS10-NUDT3","-",17,9,38,14,41,22,21,17,9,5,0.753130242212863,0.324675324675324,"NUDT3, RPS10",FALSE,TRUE,TRUE,FALSE,NA
"'CD96","+",12,7,19,13,19,21,12,7,10,3,0.467316341829086,0.322344322344323,"ZBED2",FALSE,TRUE,TRUE,FALSE,NA
"'IPO7","+",14,9,17,13,18,21,6,11,7,6,0.460088351814068,0.322344322344323,"SNORA23",FALSE,TRUE,TRUE,FALSE,NA
"'BICD1","+",9,3,9,4,11,7,4,5,2,2,1,0.321428571428571,"",FALSE,TRUE,TRUE,FALSE,NA
"'NMT1","+",10,3,14,4,16,7,6,8,3,1,0.576470588235294,0.321428571428571,"",TRUE,TRUE,TRUE,FALSE,NA
"'NSD1","+",30,15,122,51,142,76,62,60,45,6,0.0000022187676552251,0.321172248803828,"",TRUE,TRUE,TRUE,FALSE,NA
"'USP53","+",5,4,6,5,8,10,4,2,3,2,1,0.32,"LOC101929762",FALSE,TRUE,TRUE,FALSE,NA
"'TDRD3","+",17,7,28,17,32,22,13,15,9,8,0.76310372230841,0.318181818181818,"",FALSE,TRUE,TRUE,FALSE,NA
"'SOS2","-",10,4,15,6,16,11,8,7,4,2,0.659442724458204,0.318181818181818,"",FALSE,TRUE,TRUE,FALSE,NA
"'CSNK2A1","-",11,7,23,16,25,25,15,8,11,5,1,0.3175,"",TRUE,TRUE,TRUE,FALSE,NA
"'PTEN","+",16,6,34,10,39,14,14,20,8,2,0.0688818317859724,0.317460317460317,"KLLN",TRUE,TRUE,TRUE,FALSE,NA
"'PTPRK","-",13,10,30,23,32,34,13,17,20,3,0.00154322801115008,0.315508021390374,"LOC101928140",TRUE,TRUE,TRUE,FALSE,NA
"'ZFAND3","+",11,10,22,16,26,23,13,9,12,4,0.489843569932558,0.313664596273292,"",FALSE,TRUE,TRUE,FALSE,NA
"'RASA2","+",19,12,33,32,34,45,22,11,25,7,0.407546932179249,0.313492063492063,"",FALSE,FALSE,TRUE,TRUE,7.26892786544384
"'PCSK4","-",0,4,0,4,0,8,0,0,4,0,1,0.3125,"",FALSE,FALSE,FALSE,TRUE,3.48097398823765
"'HSPBP1","-",11,4,12,4,14,8,7,5,2,2,1,0.3125,"",FALSE,TRUE,TRUE,FALSE,NA
"'SNX13","-",15,10,25,27,26,42,8,17,21,6,0.00181783548769055,0.312380952380952,"",FALSE,FALSE,TRUE,TRUE,0.550413794960624
"'CWC25","-",12,5,13,5,17,9,7,6,3,2,1,0.311111111111111,"",FALSE,TRUE,TRUE,FALSE,NA
"'NLK","+",11,5,22,8,24,12,15,7,6,2,1,0.309523809523809,"",FALSE,TRUE,TRUE,FALSE,NA
"'DOCK3","+",14,7,28,9,30,15,13,15,3,6,0.70229821286551,0.308333333333334,"",FALSE,TRUE,TRUE,FALSE,NA
"'TCERG1","+",10,9,14,15,18,22,9,5,11,4,0.699850074962519,0.307692307692307,"",FALSE,TRUE,TRUE,FALSE,NA
"'CHORDC1","-",8,9,13,14,14,23,3,10,10,4,0.0213009078536068,0.307453416149068,"",FALSE,TRUE,TRUE,FALSE,NA
"'TAPBP","-",15,7,36,16,40,23,18,18,8,8,1,0.307246376811595,"",FALSE,TRUE,TRUE,FALSE,NA
"'LRPPRC","-",6,10,6,15,6,23,3,3,9,6,1,0.307246376811595,"",FALSE,TRUE,TRUE,FALSE,NA
"'NARF","+",19,11,45,22,61,35,24,21,19,3,0.013458299723484,0.304761904761905,"",FALSE,TRUE,TRUE,FALSE,NA
"'PPP3CA","-",15,17,34,45,41,61,15,19,25,20,0.367472207919732,0.304508196721311,"MIR8066, MIR1255A",FALSE,TRUE,TRUE,FALSE,NA
"'MED17","+",2,3,2,3,2,11,0,2,3,0,0.1,0.303030303030303,"",FALSE,TRUE,TRUE,FALSE,NA
"'CCDC57","-",30,15,140,43,156,65,73,67,20,23,0.601667641101547,0.300384615384615,"",FALSE,TRUE,TRUE,FALSE,NA
"'E4F1","+",8,2,10,2,12,10,3,7,1,1,1,0.3,"",FALSE,TRUE,TRUE,FALSE,NA
"'PTPN12","+",9,2,13,2,16,5,4,9,1,1,1,0.3,"",FALSE,TRUE,TRUE,FALSE,NA
"'STK11","+",18,7,47,10,53,15,21,26,4,6,1,0.3,"",TRUE,TRUE,TRUE,FALSE,NA
"'SMC6","-",6,3,8,8,8,13,3,5,5,3,0.619269619269619,0.298076923076923,"",FALSE,TRUE,TRUE,FALSE,NA
"'MROH1","+",35,13,299,86,351,125,153,146,45,41,0.902792893112752,0.297743589743586,"",FALSE,TRUE,TRUE,FALSE,NA
"'MAPK8IP3","+",28,12,109,37,138,55,59,50,19,18,0.84944895278573,0.296791443850267,"MIR3177",FALSE,TRUE,TRUE,FALSE,NA
"'ATP8A1","-",15,8,25,19,31,31,10,15,16,3,0.00498832619478425,0.295698924731183,"",FALSE,TRUE,TRUE,FALSE,NA
"'GPATCH8","-",26,13,79,38,83,54,42,37,28,10,0.0441120472275212,0.295238095238094,"",FALSE,TRUE,TRUE,FALSE,NA
"'PHF3","+",10,10,14,21,16,30,6,8,17,4,0.0312606599925844,0.293333333333333,"",FALSE,TRUE,TRUE,TRUE,1.77091947382572
"'CLASP2","-",12,7,19,15,21,22,10,9,10,5,0.495296706485467,0.292207792207792,"",FALSE,TRUE,TRUE,FALSE,NA
"'PDZD8","-",10,8,10,12,12,20,6,4,8,4,1,0.291666666666667,"",FALSE,TRUE,TRUE,FALSE,NA
"'GRK6","+",6,3,8,5,8,11,5,3,2,3,0.592074592074592,0.290909090909091,"PRR7-AS1",FALSE,TRUE,TRUE,FALSE,NA
"'C19orf25","-",1,3,1,3,2,7,1,0,3,0,1,0.285714285714286,"APC2",FALSE,FALSE,TRUE,TRUE,3.48097398823765
"'GGA3","-",7,7,11,7,11,11,10,1,6,1,1,0.285714285714286,"MRPS7",FALSE,TRUE,TRUE,FALSE,NA
"'NFKBID","-",16,7,26,23,30,33,15,11,12,11,0.777684724202801,0.285714285714286,"",FALSE,TRUE,TRUE,FALSE,NA
"'TRAF2","+",34,10,105,32,126,43,44,61,17,15,0.311830820917136,0.283222591362126,"MIR4479",FALSE,TRUE,TRUE,FALSE,NA
"'CTCF","+",22,10,65,26,76,37,30,35,16,10,0.24676326047367,0.27891891891892,"",FALSE,TRUE,TRUE,FALSE,NA
"'CLEC2B","-",9,7,16,14,17,20,7,9,10,4,0.158978405534075,0.278571428571428,"",FALSE,TRUE,TRUE,FALSE,NA
"'CREBBP","-",23,15,64,53,65,70,31,33,39,14,0.00785457137810589,0.278419452887539,"",TRUE,FALSE,TRUE,TRUE,2.79174547453273
"'SARNP","-",19,15,43,34,48,48,21,22,27,7,0.00884744476324452,0.27734375,"GDF11",TRUE,FALSE,TRUE,TRUE,6.6848152464621
"'EYA3","-",14,11,29,36,30,49,11,18,26,10,0.0111030505129267,0.274309723889557,"",FALSE,FALSE,TRUE,TRUE,0.0503218528291519
"'GCN1","-",11,9,16,17,16,25,5,11,13,4,0.0149191803234052,0.2725,"MIR4498",FALSE,FALSE,TRUE,TRUE,3.48097398823765
"'WRB-SH3BGR","+",2,3,2,3,2,5,1,1,1,2,1,0.266666666666667,"WRB, LCA5L, SH3BGR, MIR6508",FALSE,FALSE,TRUE,TRUE,3.87869528783106
"'PRR7-AS1","-",6,3,7,3,7,5,2,5,2,1,0.5,0.266666666666667,"GRK6, PRR7",FALSE,TRUE,TRUE,FALSE,NA
"'KCMF1","+",10,3,14,3,15,5,9,5,1,2,0.536764705882353,0.266666666666667,"",TRUE,TRUE,TRUE,FALSE,NA
"'SETDB2","+",7,2,8,3,9,5,4,4,1,2,1,0.266666666666667,"SETDB2-PHF11",FALSE,TRUE,TRUE,FALSE,NA
"'SUPT3H","-",19,14,65,53,67,73,32,33,34,19,0.136150613447571,0.26645178619393,"MIR586, RUNX2",FALSE,TRUE,TRUE,FALSE,NA
"'VARS","-",26,8,90,27,105,41,41,49,17,10,0.128983228704141,0.261463414634147,"",FALSE,TRUE,TRUE,FALSE,NA
"'AXIN1","-",18,10,36,20,40,28,17,19,11,9,0.780787877951279,0.260714285714286,"",TRUE,TRUE,TRUE,FALSE,NA
"'GAK","-",8,9,13,20,16,26,6,7,13,7,0.472002708323258,0.260683760683761,"TMEM175",TRUE,FALSE,TRUE,TRUE,0.980038544139147
"'MRPS28","-",7,5,9,8,11,13,5,4,5,3,1,0.259615384615385,"",FALSE,TRUE,TRUE,FALSE,NA
"'NPHP3-ACAD11","-",11,8,19,10,24,14,9,10,7,3,0.433483258370815,0.257142857142857,"ACAD11, ACKR4, UBA5, NPHP3, NPHP3-AS1",FALSE,TRUE,TRUE,FALSE,NA
"'CEP350","+",12,7,18,10,22,14,8,10,8,2,0.114394682358069,0.257142857142857,"",FALSE,TRUE,TRUE,FALSE,NA
"'UBAP2","-",13,8,18,15,19,22,9,9,12,3,0.145066982637713,0.254545454545454,"SNORD121B, SNORD121A",FALSE,TRUE,TRUE,FALSE,0.527246214813246
"'TRPC4AP","-",10,10,26,18,27,28,13,13,12,6,0.358557412598362,0.253968253968254,"MYH7B",FALSE,TRUE,TRUE,FALSE,NA
"'SMG1P2","-",26,14,55,37,56,52,26,29,26,11,0.0339395442176321,0.253205128205128,"MIR3680-2, MIR3680-1",FALSE,FALSE,TRUE,TRUE,1.06489767258589
"'WWP1","+",13,9,15,23,17,32,6,9,15,8,0.185295640468054,0.252840909090909,"",TRUE,TRUE,TRUE,FALSE,NA
"'ASCC3","-",15,8,22,36,23,48,13,9,20,16,1,0.25,"",FALSE,FALSE,TRUE,TRUE,4.97324273626338
"'PDP2","+",0,2,0,4,0,6,0,0,1,3,1,0.25,"",FALSE,FALSE,FALSE,TRUE,0.204497608328823
"'ZNF707","+",4,3,6,4,6,6,3,3,3,1,0.571428571428572,0.25,"",FALSE,TRUE,TRUE,FALSE,NA
"'TTC19","+",4,3,5,4,5,6,3,2,2,2,1,0.25,"ZSWIM7",FALSE,TRUE,TRUE,FALSE,NA
"'ITPR1","+",11,8,14,9,14,17,9,5,5,4,1,0.248366013071895,"EGOT",FALSE,TRUE,TRUE,FALSE,NA
"'TCF3","-",14,5,30,8,37,13,12,18,4,4,0.698446074157649,0.241758241758242,"",TRUE,FALSE,TRUE,TRUE,3.48097398823765
"'CBLB","-",21,12,49,34,55,45,21,28,20,14,0.183886613073969,0.240972222222222,"",TRUE,TRUE,TRUE,FALSE,NA
"'MARS","+",9,6,12,6,12,9,5,7,4,2,0.619909502262444,0.240740740740741,"ARHGAP9, MIR6758, DDIT3",TRUE,TRUE,TRUE,FALSE,NA
"'ZNF407","+",14,11,23,27,27,36,12,11,15,12,1,0.232905982905983,"",FALSE,TRUE,TRUE,FALSE,NA
"'MGEA5","-",12,10,21,13,25,18,13,8,11,2,0.250778642936597,0.230769230769231,"",FALSE,TRUE,TRUE,FALSE,NA
"'DENND6A","-",7,5,10,12,11,17,3,7,7,5,0.230531078828293,0.230392156862745,"PDE12",FALSE,TRUE,TRUE,FALSE,NA
"'SETDB2-PHF11","+",10,3,11,5,12,7,5,6,2,3,1,0.228571428571429,"SETDB2, PHF11",FALSE,TRUE,TRUE,FALSE,NA
"'RPL22","-",4,4,4,10,4,15,3,1,7,3,1,0.228571428571428,"",TRUE,TRUE,TRUE,FALSE,NA
"'SMG1P5","-",23,16,59,47,70,60,26,33,35,12,0.00280777897339298,0.228030303030303,"",FALSE,TRUE,TRUE,TRUE,0.274189284161613
"'PPP1R37","+",5,4,6,7,6,9,3,3,4,3,1,0.222222222222222,"",FALSE,TRUE,TRUE,FALSE,NA
"'ZNF589","+",10,3,15,4,16,9,9,6,1,3,0.303405572755418,0.222222222222222,"",FALSE,TRUE,TRUE,FALSE,NA
"'BCORP1","-",1,3,1,3,1,6,1,0,2,1,1,0.222222222222222,"",FALSE,TRUE,TRUE,FALSE,NA
"'PDE12","+",5,7,9,13,11,18,4,5,8,5,0.665634674922601,0.222222222222222,"ARF4, ARF4-AS1, DENND6A",FALSE,TRUE,TRUE,FALSE,NA
"'WDR7","+",21,11,38,21,45,29,15,23,14,7,0.0596015801738957,0.220032840722496,"",FALSE,TRUE,TRUE,FALSE,NA
"'CRTC3","+",15,8,41,16,44,21,23,18,12,4,0.235739520765777,0.217261904761905,"CRTC3-AS1",TRUE,TRUE,TRUE,FALSE,NA
"'NUB1","+",9,6,9,7,10,12,6,3,3,4,0.61451048951049,0.214285714285714,"",FALSE,TRUE,TRUE,FALSE,NA
"'CCNF","+",24,12,59,28,67,37,34,25,23,5,0.0304501887922171,0.212212212212212,"MIR6767",TRUE,TRUE,TRUE,FALSE,NA
"'MYO6","+",3,3,3,6,3,8,2,1,4,2,1,0.208333333333333,"",FALSE,FALSE,TRUE,TRUE,1.05836086258276
"'R3HDM1","+",10,6,12,6,15,8,6,6,5,1,0.315610859728507,0.208333333333333,"MIR128-1",FALSE,TRUE,TRUE,FALSE,NA
"'SYMPK","-",14,9,34,22,34,28,16,18,16,6,0.0963844160970606,0.207482993197279,"",FALSE,TRUE,TRUE,FALSE,NA
"'AP3B1","-",15,11,21,24,23,31,8,13,13,11,0.372749124933849,0.205645161290323,"",FALSE,TRUE,TRUE,FALSE,NA
"'FKBP15","-",4,2,4,6,4,11,3,1,3,3,0.571428571428572,0.204545454545455,"",FALSE,TRUE,TRUE,FALSE,NA
"'WDR11","+",7,6,8,7,8,11,2,6,4,3,0.314685314685315,0.196969696969697,"WDR11-AS1",TRUE,TRUE,TRUE,FALSE,NA
"'SMYD3","-",13,6,15,10,16,13,10,5,2,8,0.0414053035401804,0.192307692307693,"",TRUE,TRUE,TRUE,FALSE,NA
"'KANSL3","-",6,5,7,7,12,9,3,4,4,3,1,0.19047619047619,"",FALSE,TRUE,TRUE,FALSE,NA
"'RWDD4","-",2,1,4,3,4,7,3,1,3,0,1,0.19047619047619,"",FALSE,TRUE,TRUE,FALSE,NA
"'USP9X","+",9,6,19,7,20,9,12,7,6,1,0.374788689571298,0.19047619047619,"",FALSE,TRUE,TRUE,FALSE,NA
"'PELP1","-",16,13,31,31,32,37,14,17,23,8,0.0373675354940917,0.188257222739982,"LOC101559451",FALSE,FALSE,TRUE,TRUE,0.833026602996393
"'RBM26","-",21,8,31,18,34,22,18,13,14,4,0.219203839232871,0.181818181818183,"",FALSE,TRUE,TRUE,FALSE,NA
"'PAPOLA","+",7,6,13,17,15,20,4,9,14,3,0.00801809621505037,0.181249999999999,"",FALSE,FALSE,TRUE,TRUE,7.26892786544384
"'RABGAP1L","+",17,12,27,23,29,28,18,9,12,11,0.388284827833193,0.172077922077922,"GPR52, LOC101928696",TRUE,TRUE,TRUE,FALSE,NA
"'UNC5C","-",3,4,4,5,4,7,3,1,4,1,1,0.171428571428571,"",FALSE,TRUE,TRUE,FALSE,NA
"'SENP6","+",17,10,28,23,31,29,11,17,19,4,0.00372377161337958,0.16791604197901,"",FALSE,FALSE,TRUE,TRUE,1.05836086258276
"'TPM4","+",7,5,12,7,15,8,7,5,4,3,1,0.166666666666667,"",TRUE,TRUE,TRUE,FALSE,NA
"'MYADM","+",2,2,3,2,3,3,2,1,2,0,1,0.166666666666667,"",FALSE,TRUE,TRUE,FALSE,NA
"'ZNF354B","+",3,2,4,2,4,9,2,2,2,0,0.466666666666667,0.166666666666667,"",FALSE,TRUE,TRUE,FALSE,NA
"'SLC39A8","-",3,3,4,3,5,4,1,3,1,2,1,0.166666666666667,"",FALSE,TRUE,TRUE,FALSE,NA
"'ZNF618","+",1,3,1,3,1,4,0,1,2,1,1,0.166666666666667,"",FALSE,TRUE,TRUE,FALSE,NA
"'ZNF827","-",8,2,10,3,13,4,6,4,1,2,0.559440559440559,0.166666666666667,"",FALSE,TRUE,TRUE,FALSE,NA
"'NNT-AS1","-",0,3,0,3,0,4,0,0,1,2,1,0.166666666666667,"NNT",FALSE,TRUE,TRUE,FALSE,NA
"'MIR5096","+",12,7,20,13,20,16,11,9,10,3,0.277518498815109,0.166666666666667,"SPEN, GNG4, LYST, BMP2K, ZZEF1, CYB5D2, ANKFY1, LGALS1, NOL12, TRIOBP, H1F0, GCAT, GALR3, ANKRD54, MIR658, MIR659, EIF3L, MICALL1, C22orf23, POLR2F, MIR6820, SOX10, MIR4534",FALSE,TRUE,TRUE,TRUE,1.7740421349779
"'SMG1P1","+",19,14,26,38,26,40,9,17,26,12,0.0107846240428835,0.16060606060606,"RRN3P3",FALSE,FALSE,TRUE,TRUE,0.0217997746431523
"'CLTC","+",12,10,17,20,17,23,12,5,15,5,1,0.155606407322654,"",TRUE,FALSE,TRUE,TRUE,2.80314233174088
"'PHIP","-",21,11,42,26,49,31,23,19,16,10,0.622414928328109,0.152605459057073,"",TRUE,TRUE,TRUE,FALSE,NA
"'MBD3","-",10,6,14,13,15,15,5,9,11,2,0.0183066361556064,0.15,"",FALSE,FALSE,TRUE,TRUE,3.48097398823765
"'CDK17","-",13,7,20,17,20,21,15,5,12,5,1,0.145658263305322,"",FALSE,TRUE,TRUE,FALSE,NA
"'SRSF2","-",9,5,10,5,12,6,2,8,5,0,0.00699300699300699,0.133333333333334,"MIR636, MFSD11",TRUE,FALSE,FALSE,TRUE,0.0577591979432278
"'MIR636","-",6,5,7,5,8,6,1,6,5,0,0.0151515151515152,0.133333333333334,"SRSF2",FALSE,FALSE,FALSE,TRUE,0.0577591979432278
"'UQCR11","-",10,5,11,6,12,6,4,7,6,0,0.0345022624434389,0.133333333333334,"",FALSE,FALSE,TRUE,TRUE,3.48097398823765
"'SLC35A5","+",0,2,0,2,0,8,0,0,1,1,1,0.125,"ATG3",FALSE,TRUE,TRUE,FALSE,NA
"'MFSD11","+",19,7,36,18,46,21,25,11,10,8,0.372406144281109,0.11904761904762,"SRSF2",FALSE,FALSE,TRUE,TRUE,0.0577591979432278
"'PEX5","+",8,4,11,12,11,14,3,8,11,1,0.00275945618522008,0.119047619047619,"",FALSE,FALSE,TRUE,TRUE,0.343990000415651
"'DNAH6","+",10,8,15,12,19,14,6,9,4,8,1,0.119047619047619,"",FALSE,TRUE,TRUE,FALSE,NA
"'DUSP11","-",2,2,2,4,2,7,1,1,3,1,1,0.0952380952380952,"",FALSE,TRUE,TRUE,FALSE,NA
"'NAE1","-",5,6,8,11,8,11,5,3,8,3,1,0.081818181818182,"",FALSE,FALSE,TRUE,TRUE,0.204497608328823
"'SMG1P7","-",7,7,8,12,8,12,6,2,7,5,0.642414860681115,0.0757575757575757,"",FALSE,FALSE,FALSE,TRUE,0.37159895583753
"'SREK1","+",3,2,3,4,3,9,3,0,4,0,1,0.0555555555555556,"",FALSE,TRUE,TRUE,FALSE,NA
"'ATAD3A","+",12,1,15,1,17,1,7,8,0,1,1,0,"",FALSE,FALSE,FALSE,TRUE,1.38675131315115
"'NRBF2","+",1,2,1,2,1,2,1,0,2,0,1,0,"",FALSE,FALSE,FALSE,TRUE,5.28304253313552
"'TBC1D12","+",2,2,2,2,2,2,0,2,1,1,1,0,"",FALSE,FALSE,FALSE,TRUE,0.316030041287781
"'APOF","-",2,1,2,1,2,1,0,2,1,0,0.333333333333333,0,"",FALSE,FALSE,FALSE,TRUE,6.6848152464621
"'MIR4498","-",1,1,1,1,1,1,0,1,0,1,1,0,"GCN1",FALSE,FALSE,FALSE,TRUE,3.48097398823765
"'LOC100190986","+",3,4,3,6,3,6,1,2,3,3,1,0,"",FALSE,FALSE,FALSE,TRUE,0.0217997746431523
"'LOC100190986","-",0,1,0,1,0,1,0,0,0,1,1,0,"",FALSE,FALSE,FALSE,TRUE,0.0217997746431523
"'NPIPB5","+",2,2,2,2,2,2,0,2,1,1,1,0,"",FALSE,FALSE,FALSE,TRUE,0.0217997746431523
"'LOC653786","+",1,3,1,3,1,3,0,1,2,1,1,0,"",FALSE,FALSE,FALSE,TRUE,0.0217997746431523
"'PDPR","+",0,1,0,3,0,6,0,0,0,3,1,0,"LOC400541",FALSE,FALSE,TRUE,TRUE,0.37159895583753
"'LOC400541","-",0,1,0,3,0,6,0,0,3,0,1,0,"PDPR",FALSE,FALSE,TRUE,TRUE,0.37159895583753
"'MIR5096","+",6,5,6,7,6,7,3,3,2,5,0.592074592074592,0,"SPEN, GNG4, LYST, BMP2K, ZZEF1, CYB5D2, ANKFY1, LGALS1, NOL12, TRIOBP, H1F0, GCAT, GALR3, ANKRD54, MIR658, MIR659, EIF3L, MICALL1, C22orf23, POLR2F, MIR6820, SOX10, MIR4534",FALSE,TRUE,TRUE,TRUE,1.7740421349779
"'CYB5D2","+",3,1,3,3,3,6,1,2,0,3,1,0,"MIR5096",FALSE,FALSE,FALSE,TRUE,1.7740421349779
"'DHX40","+",2,4,2,4,2,4,0,2,2,2,0.466666666666667,0,"",FALSE,FALSE,FALSE,TRUE,4.57068975071843
"'REEP6","+",0,1,0,1,0,1,0,0,0,1,1,0,"",FALSE,FALSE,FALSE,TRUE,3.48097398823765
"'PLK5","+",0,1,0,1,0,1,0,0,0,1,1,0,"",FALSE,FALSE,TRUE,TRUE,3.48097398823765
"'MEX3D","-",1,1,1,1,1,1,1,0,0,1,1,0,"",FALSE,FALSE,FALSE,TRUE,3.48097398823765
"'MAN2B1","-",7,5,9,10,9,10,5,4,9,1,0.140866873065016,0,"",FALSE,FALSE,TRUE,TRUE,7.59119386086158
"'WDR83","+",1,3,1,4,1,4,1,0,1,3,0.4,0,"WDR83OS, DHPS",FALSE,FALSE,FALSE,TRUE,7.59119386086158
"'DHPS","-",1,2,1,2,1,2,1,0,1,1,1,0,"WDR83",FALSE,FALSE,TRUE,TRUE,7.59119386086158
"'LCA5L","-",1,1,1,1,1,1,1,0,1,0,1,0,"WRB-SH3BGR",FALSE,FALSE,TRUE,TRUE,3.87869528783106
"'ACTL6A","+",6,1,6,2,7,46,4,2,2,0,1,0,"",FALSE,TRUE,TRUE,FALSE,NA
"'CD109","+",11,1,13,1,14,32,4,9,1,0,0.357142857142857,0,"LOC101928489",TRUE,TRUE,TRUE,FALSE,NA
"'RBAK","+",4,1,4,3,4,30,2,2,3,0,0.428571428571429,0,"RBAK-RBAKDN",FALSE,TRUE,TRUE,FALSE,NA
"'RBAK-RBAKDN","+",4,1,4,3,4,30,2,2,3,0,0.428571428571429,0,"RBAK, RBAKDN",FALSE,TRUE,TRUE,FALSE,NA
"'C19orf48","-",3,1,4,4,5,51,2,2,4,0,0.428571428571429,0,"SNORD88B, SNORD88A, SNORD88C",FALSE,TRUE,TRUE,FALSE,NA
"'KARS","-",2,1,2,2,2,26,1,1,2,0,1,0,"",FALSE,TRUE,TRUE,FALSE,NA
"'F2R","+",1,1,1,3,1,26,0,1,0,3,1,0,"",FALSE,TRUE,TRUE,FALSE,NA
"'RPIA","+",2,1,2,2,2,23,2,0,0,2,0.333333333333333,0,"",FALSE,TRUE,TRUE,FALSE,NA
"'ANKRD40","-",0,1,0,2,0,24,0,0,2,0,1,0,"",FALSE,TRUE,TRUE,FALSE,NA
"'ABCD1","+",3,1,4,1,4,18,1,3,0,1,1,0,"",FALSE,TRUE,TRUE,FALSE,NA
"'LINC02256","+",1,1,1,3,1,21,0,1,3,0,0.25,0,"",FALSE,TRUE,TRUE,FALSE,NA
"'SLC35F6","+",3,1,3,1,4,6,2,1,1,0,1,0,"",FALSE,TRUE,TRUE,FALSE,NA
"'PTPDC1","+",3,1,3,1,3,5,2,1,1,0,1,0,"",FALSE,TRUE,TRUE,FALSE,NA
"'ITIH5","-",1,1,1,1,1,5,1,0,1,0,1,0,"",FALSE,TRUE,TRUE,FALSE,NA
"'DNAJC14","-",5,1,5,2,6,17,3,2,2,0,1,0,"ORMDL2, TMEM198B",FALSE,TRUE,TRUE,FALSE,NA
"'ZNF876P","+",1,1,1,2,1,9,1,0,2,0,1,0,"",FALSE,TRUE,TRUE,FALSE,NA
"'RCSD1","+",4,3,4,3,4,3,2,2,2,1,1,0,"",FALSE,TRUE,TRUE,FALSE,NA
"'KLF7","-",6,2,10,2,10,2,6,4,1,1,1,0,"MIR2355, MIR7845",FALSE,TRUE,TRUE,FALSE,NA
"'CPNE4","-",2,2,2,2,2,2,0,2,1,1,1,0,"MIR5704",FALSE,TRUE,TRUE,FALSE,NA
"'CXXC4-AS1","+",0,1,0,1,0,1,0,0,0,1,1,0,"CXXC4",FALSE,TRUE,TRUE,FALSE,NA
"'ARSB","-",1,2,1,2,1,2,0,1,2,0,0.333333333333333,0,"",FALSE,TRUE,TRUE,FALSE,NA
"'AGBL1","+",4,5,4,5,4,5,3,1,3,2,1,0,"LINC01584, AGBL1-AS1, LOC105370954, LOC102724452",FALSE,TRUE,TRUE,FALSE,NA
"'ADGRG4","+",0,1,0,1,0,5,0,0,1,0,1,0,"",FALSE,TRUE,TRUE,FALSE,NA
"'AKT2","-",6,1,7,1,9,6,3,4,1,0,1,0,"MIR641",TRUE,TRUE,TRUE,FALSE,NA
"'MICAL2","+",6,1,7,4,7,76,4,3,4,0,0.236363636363637,0,"MIR6124",FALSE,TRUE,TRUE,FALSE,NA
"'LOC101927501","+",0,1,0,2,0,36,0,0,2,0,1,0,"",FALSE,TRUE,TRUE,FALSE,NA
"'LOC100128993","-",0,1,0,1,0,4,0,0,0,1,1,0,"",FALSE,TRUE,TRUE,FALSE,NA
"'ARF1","+",1,1,1,2,1,18,0,1,2,0,0.333333333333333,0,"MIR3620",FALSE,TRUE,TRUE,FALSE,NA
"'LOC100288637","-",4,4,5,4,5,4,2,3,2,2,1,0,"OTUD7A, CHRNA7, LINC02249, GOLGA8H, GOLGA8K, GOLGA8T, ULK4P1, ULK4P2",FALSE,TRUE,TRUE,FALSE,NA
"'LRIF1","-",1,1,1,1,1,6,1,0,1,0,1,0,"",FALSE,TRUE,TRUE,FALSE,NA
"'PLEKHM3","-",2,1,2,1,2,6,2,0,1,0,1,0,"",FALSE,TRUE,TRUE,FALSE,NA
"'TWISTNB","-",6,1,6,1,6,6,3,3,0,1,1,0,"MIR3146",FALSE,TRUE,TRUE,FALSE,NA
"'NSMF","-",2,1,2,2,4,5,0,2,2,0,0.333333333333333,0,"MIR7114",FALSE,TRUE,TRUE,FALSE,NA
